,WhiteNotHs_TE,WhiteNotHs_belowPoverty,WhiteNotHs_Male_BP,WhiteNotHs_Female_BP,GEO_ID,Fips_Code,Name,subregion,region,AfAmer_TE,AfAmer_belowPoverty,AfAmer_Male_BP,AfAmer_Female_BP,TwoOrMore_TE,TwoOrMore_belowPoverty,TwoOrMore_Male_BP,TwoOrMore_Female_BP,HawaiPacific_TE,HawaiPacific_belowPoverty,HawaiPacific_Male_BP,HawaiPacific_Female_BP,HispLatino_TE,HispLatino_belowPoverty,HispLatino_Male_BP,HispLatino_Female_BP,AsianAlone_TE,AsianAlone_belowPoverty,AsianAlone_Male_BP,AsianAlone_Female_BP,AmerIndAlsakan_TE,AmerIndAlsakan_belowPoverty,AmerIndAlsakan_Male_BP,AmerIndAlsakan_Female_BP,OtherRace_TE,OtherRace_belowPoverty,OtherRace_Male_BP,OtherRace_Female_BP
2,40836,4725,1925,2800,0500000US01001,1001,"Autauga County, Alabama",Autauga County, Alabama,10755,3211,1274,1937,1413,273,121,152,24,0,0,0,1595,168,112,56,649,36,0,36,155,23,23,0,365,73,38,35
3,178997,13699,5420,8279,0500000US01003,1003,"Baldwin County, Alabama",Baldwin County, Alabama,18417,3274,1282,1992,5569,680,234,446,10,0,0,0,9710,1770,738,1032,2033,97,0,97,1383,560,251,309,3271,625,198,427
4,10326,1410,612,798,0500000US01005,1005,"Barbour County, Alabama",Barbour County, Alabama,10192,4020,1513,2507,428,230,124,106,1,1,0,1,998,704,263,441,116,0,0,0,43,0,0,0,777,486,192,294
5,15988,2245,1191,1054,0500000US01007,1007,"Bibb County, Alabama",Bibb County, Alabama,4172,1480,665,815,84,0,0,0,0,0,0,0,540,30,9,21,56,0,0,0,2,0,0,0,0,0,0,0
6,49581,6222,2388,3834,0500000US01009,1009,"Blount County, Alabama",Blount County, Alabama,672,87,54,33,1293,121,55,66,55,0,0,0,5354,1431,774,657,236,6,6,0,55,11,11,0,1029,249,166,83
7,2031,52,13,39,0500000US01011,1011,"Bullock County, Alabama",Bullock County, Alabama,6671,2234,1109,1125,55,0,0,0,0,0,0,0,817,496,233,263,137,81,0,81,0,0,0,0,318,16,14,2
8,9875,844,345,499,0500000US01013,1013,"Butler County, Alabama",Butler County, Alabama,8730,2611,805,1806,323,213,59,154,0,0,0,0,290,152,31,121,261,69,51,18,66,0,0,0,98,10,10,0
9,80099,9852,3905,5947,0500000US01015,1015,"Calhoun County, Alabama",Calhoun County, Alabama,23358,6033,2662,3371,2663,668,340,328,310,0,0,0,4311,782,385,397,919,145,62,83,352,225,102,123,1868,289,170,119
10,18088,2347,1139,1208,0500000US01017,1017,"Chambers County, Alabama",Chambers County, Alabama,13168,2202,618,1584,318,52,44,8,9,0,0,0,838,381,116,265,368,40,40,0,63,16,16,0,264,43,19,24
11,23538,2863,1304,1559,0500000US01019,1019,"Cherokee County, Alabama",Cherokee County, Alabama,1187,155,137,18,376,84,4,80,0,0,0,0,422,181,95,86,26,20,6,14,150,31,31,0,212,169,95,74
12,34793,5452,2609,2843,0500000US01021,1021,"Chilton County, Alabama",Chilton County, Alabama,4172,880,288,592,1266,195,45,150,0,0,0,0,3340,958,496,462,195,0,0,0,504,141,42,99,1571,433,348,85
13,7067,619,268,351,0500000US01023,1023,"Choctaw County, Alabama",Choctaw County, Alabama,5329,1777,797,980,61,49,0,49,0,0,0,0,60,33,18,15,25,0,0,0,7,0,0,0,11,0,0,0
14,12229,1770,753,1017,0500000US01025,1025,"Clarke County, Alabama",Clarke County, Alabama,10748,4021,1686,2335,256,22,15,7,0,0,0,0,140,24,15,9,107,1,0,1,9,0,0,0,47,47,47,0
15,10490,1216,525,691,0500000US01027,1027,"Clay County, Alabama",Clay County, Alabama,1947,614,256,358,121,40,19,21,0,0,0,0,410,148,60,88,33,0,0,0,20,0,0,0,6,0,0,0
16,13679,1859,667,1192,0500000US01029,1029,"Cleburne County, Alabama",Cleburne County, Alabama,363,163,2,161,297,90,0,90,0,0,0,0,367,169,109,60,1,0,0,0,18,0,0,0,281,126,88,38
17,35893,3280,1308,1972,0500000US01031,1031,"Coffee County, Alabama",Coffee County, Alabama,8685,2818,1348,1470,2260,796,188,608,0,0,0,0,3913,1309,590,719,843,5,0,5,523,141,96,45,593,339,170,169
18,42359,5248,2375,2873,0500000US01033,1033,"Colbert County, Alabama",Colbert County, Alabama,8810,2216,1035,1181,1126,462,69,393,57,0,0,0,1591,476,232,244,277,37,0,37,313,33,0,33,985,383,203,180
19,6093,631,268,363,0500000US01035,1035,"Conecuh County, Alabama",Conecuh County, Alabama,5844,1347,550,797,78,0,0,0,0,0,0,0,59,13,0,13,70,25,0,25,20,0,0,0,0,0,0,0
20,6703,493,241,252,0500000US01037,1037,"Coosa County, Alabama",Coosa County, Alabama,3259,767,427,340,77,0,0,0,0,0,0,0,137,0,0,0,0,0,0,0,32,23,0,23,68,0,0,0
21,30351,4511,1987,2524,0500000US01039,1039,"Covington County, Alabama",Covington County, Alabama,4466,1401,525,876,630,184,122,62,32,32,0,32,657,290,165,125,245,101,58,43,73,0,0,0,133,10,0,10
22,9535,997,466,531,0500000US01041,1041,"Crenshaw County, Alabama",Crenshaw County, Alabama,3246,754,312,442,316,145,71,74,0,0,0,0,305,45,8,37,183,0,0,0,104,69,24,45,58,0,0,0
23,75155,9256,4306,4950,0500000US01043,1043,"Cullman County, Alabama",Cullman County, Alabama,746,129,72,57,2700,477,161,316,0,0,0,0,3629,530,256,274,304,11,0,11,295,0,0,0,758,82,41,41
24,32799,5371,2357,3014,0500000US01045,1045,"Dale County, Alabama",Dale County, Alabama,9919,2596,1207,1389,1446,241,138,103,0,0,0,0,3093,454,199,255,572,88,0,88,413,53,6,47,1015,306,153,153
25,10117,1377,527,850,0500000US01047,1047,"Dallas County, Alabama",Dallas County, Alabama,26899,9447,3905,5542,181,89,44,45,11,0,0,0,108,19,1,18,241,0,0,0,48,43,17,26,1,1,0,1
26,56504,9071,3947,5124,0500000US01049,1049,"DeKalb County, Alabama",DeKalb County, Alabama,955,140,40,100,2508,488,340,148,92,26,0,26,10530,4892,2428,2464,76,0,0,0,850,209,77,132,6256,3451,1664,1787
27,57485,4387,1752,2635,0500000US01051,1051,"Elmore County, Alabama",Elmore County, Alabama,14897,2920,1128,1792,1549,273,51,222,0,0,0,0,2334,608,328,280,749,81,64,17,165,6,3,3,571,95,39,56
28,21034,3418,1335,2083,0500000US01053,1053,"Escambia County, Alabama",Escambia County, Alabama,9890,4009,1593,2416,505,158,74,84,43,0,0,0,800,124,69,55,90,0,0,0,1391,359,127,232,137,20,20,0
29,78910,9715,3644,6071,0500000US01055,1055,"Etowah County, Alabama",Etowah County, Alabama,16104,4406,1915,2491,2239,527,265,262,3,3,0,3,4165,1451,622,829,792,163,108,55,529,292,141,151,1284,684,278,406
30,13611,2586,1030,1556,0500000US01057,1057,"Fayette County, Alabama",Fayette County, Alabama,1951,663,341,322,391,74,43,31,0,0,0,0,80,0,0,0,98,22,12,10,0,0,0,0,1,0,0,0
31,23790,3901,1506,2395,0500000US01059,1059,"Franklin County, Alabama",Franklin County, Alabama,1219,242,98,144,539,325,190,135,6,0,0,0,5514,1498,655,843,273,251,78,173,325,18,0,18,3106,1016,477,539
32,21719,3920,1690,2230,0500000US01061,1061,"Geneva County, Alabama",Geneva County, Alabama,2613,1078,398,680,397,193,44,149,10,5,5,0,1075,410,310,100,42,0,0,0,312,38,38,0,266,114,110,4
33,1396,170,86,84,0500000US01063,1063,"Greene County, Alabama",Greene County, Alabama,6422,2574,1173,1401,225,196,156,40,0,0,0,0,221,186,134,52,0,0,0,0,38,0,0,0,39,9,9,0
34,5521,745,390,355,0500000US01065,1065,"Hale County, Alabama",Hale County, Alabama,8631,2661,1070,1591,317,162,162,0,0,0,0,0,10,0,0,0,28,0,0,0,0,0,0,0,15,0,0,0
35,11529,1114,375,739,0500000US01067,1067,"Henry County, Alabama",Henry County, Alabama,4408,1308,560,748,279,49,27,22,36,36,27,9,416,36,17,19,73,0,0,0,34,0,0,0,145,0,0,0
36,68643,7507,3229,4278,0500000US01069,1069,"Houston County, Alabama",Houston County, Alabama,28347,8991,3712,5279,2730,877,373,504,16,0,0,0,3535,995,434,561,996,122,74,48,290,69,28,41,682,100,86,14
37,45737,7261,3291,3970,0500000US01071,1071,"Jackson County, Alabama",Jackson County, Alabama,1826,336,200,136,1382,353,176,177,35,0,0,0,1519,989,502,487,220,79,9,70,559,135,55,80,438,295,219,76
38,319009,27356,11604,15752,0500000US01073,1073,"Jefferson County, Alabama",Jefferson County, Alabama,276514,63355,26355,37000,14371,3193,1632,1561,187,42,32,10,25315,6889,3302,3587,10228,1034,477,557,1097,362,177,185,10718,2999,1496,1503
39,11775,1544,777,767,0500000US01075,1075,"Lamar County, Alabama",Lamar County, Alabama,1452,756,341,415,134,90,57,33,0,0,0,0,240,10,0,10,21,0,0,0,12,9,9,0,39,0,0,0
40,76693,8739,3466,5273,0500000US01077,1077,"Lauderdale County, Alabama",Lauderdale County, Alabama,9110,2434,997,1437,2230,164,79,85,64,0,0,0,2466,278,160,118,471,60,8,52,328,195,32,163,287,12,3,9
41,25024,4229,1660,2569,0500000US01079,1079,"Lawrence County, Alabama",Lawrence County, Alabama,3428,649,261,388,1459,342,143,199,22,22,0,22,745,223,102,121,40,0,0,0,1961,21,8,13,163,0,0,0
42,105545,18910,9086,9824,0500000US01081,1081,"Lee County, Alabama",Lee County, Alabama,35776,8715,3006,5709,3540,641,230,411,7,7,7,0,5925,1289,720,569,6912,1205,737,468,338,63,8,55,1208,356,276,80
43,71838,7719,3176,4543,0500000US01083,1083,"Limestone County, Alabama",Limestone County, Alabama,11866,1955,883,1072,2444,598,209,389,43,19,0,19,5703,1638,626,1012,1412,20,0,20,892,84,0,84,2035,561,205,356
44,2398,153,86,67,0500000US01085,1085,"Lowndes County, Alabama",Lowndes County, Alabama,7353,2034,799,1235,17,10,3,7,0,0,0,0,37,9,9,0,0,0,0,0,12,0,0,0,0,0,0,0
45,2782,314,122,192,0500000US01087,1087,"Macon County, Alabama",Macon County, Alabama,13104,3435,1555,1880,210,21,21,0,0,0,0,0,46,7,7,0,23,12,12,0,15,0,0,0,12,0,0,0
46,233000,16791,7532,9259,0500000US01089,1089,"Madison County, Alabama",Madison County, Alabama,85629,17436,6560,10876,11725,1524,623,901,306,30,14,16,18126,5036,2475,2561,9515,521,337,184,2057,168,72,96,5723,1850,862,988
47,8481,630,224,406,0500000US01091,1091,"Marengo County, Alabama",Marengo County, Alabama,9760,3123,1200,1923,239,19,5,14,0,0,0,0,484,313,113,200,9,0,0,0,13,0,0,0,43,0,0,0
48,26856,4349,1888,2461,0500000US01093,1093,"Marion County, Alabama",Marion County, Alabama,980,328,165,163,537,191,104,87,0,0,0,0,741,164,108,56,18,10,0,10,136,15,9,6,481,146,90,56
49,76236,10954,4367,6587,0500000US01095,1095,"Marshall County, Alabama",Marshall County, Alabama,2699,874,509,365,3568,933,501,432,36,36,1,35,13485,6055,3085,2970,610,14,9,5,371,116,22,94,1878,444,296,148
50,230147,26314,11433,14881,0500000US01097,1097,"Mobile County, Alabama",Mobile County, Alabama,146556,39817,16678,23139,9031,1694,437,1257,61,15,0,15,11709,3218,1324,1894,7660,1706,933,773,2694,283,122,161,4555,1256,579,677
51,11180,1592,712,880,0500000US01099,1099,"Monroe County, Alabama",Monroe County, Alabama,8823,3237,1583,1654,218,91,91,0,12,4,0,4,74,0,0,0,125,0,0,0,286,53,26,27,22,0,0,0
52,72799,5534,2285,3249,0500000US01101,1101,"Montgomery County, Alabama",Montgomery County, Alabama,126401,31097,13098,17999,6038,1351,456,895,10,0,0,0,7599,2921,1384,1537,6827,676,352,324,472,99,51,48,2884,1133,669,464
53,88402,9700,3484,6216,0500000US01103,1103,"Morgan County, Alabama",Morgan County, Alabama,14557,3918,1603,2315,4081,1217,611,606,196,0,0,0,9879,2758,1276,1482,661,236,164,72,506,56,51,5,4927,1690,790,900
54,2136,379,175,204,0500000US01105,1105,"Perry County, Alabama",Perry County, Alabama,6059,2608,994,1614,4,4,4,0,0,0,0,0,161,72,72,0,0,0,0,0,0,0,0,0,97,0,0,0
55,10243,1331,602,729,0500000US01107,1107,"Pickens County, Alabama",Pickens County, Alabama,7696,3083,1277,1806,228,127,59,68,0,0,0,0,236,14,5,9,0,0,0,0,1,1,1,0,73,5,0,5
56,17616,2864,1453,1411,0500000US01109,1109,"Pike County, Alabama",Pike County, Alabama,11753,3538,1436,2102,744,147,50,97,3,0,0,0,745,235,125,110,610,460,309,151,101,3,0,3,41,12,0,12
57,16775,2652,1157,1495,0500000US01111,1111,"Randolph County, Alabama",Randolph County, Alabama,4114,846,361,485,493,234,5,229,0,0,0,0,643,378,171,207,49,20,10,10,93,0,0,0,171,171,103,68
58,25752,3458,1382,2076,0500000US01113,1113,"Russell County, Alabama",Russell County, Alabama,25657,7055,2822,4233,1747,414,213,201,30,30,30,0,3246,1406,726,680,676,100,82,18,85,44,36,8,1531,906,585,321
59,75223,7755,3774,3981,0500000US01115,1115,"St. Clair County, Alabama",St. Clair County, Alabama,7259,1378,582,796,1235,78,12,66,18,0,0,0,2155,634,364,270,668,41,35,6,482,45,19,26,722,369,227,142
60,165473,9841,4062,5779,0500000US01117,1117,"Shelby County, Alabama",Shelby County, Alabama,25502,2096,877,1219,6451,418,281,137,43,0,0,0,12218,1851,941,910,4199,367,99,268,771,2,0,2,5757,1517,735,782
61,2806,737,281,456,0500000US01119,1119,"Sumter County, Alabama",Sumter County, Alabama,8574,2858,1304,1554,115,5,5,0,0,0,0,0,146,17,0,17,140,0,0,0,8,0,0,0,39,0,0,0
62,48443,6490,2942,3548,0500000US01121,1121,"Talladega County, Alabama",Talladega County, Alabama,24188,5987,2380,3607,1699,360,170,190,151,0,0,0,1676,785,560,225,414,33,16,17,276,124,76,48,712,228,159,69
63,27531,2635,1038,1597,0500000US01123,1123,"Tallapoosa County, Alabama",Tallapoosa County, Alabama,10909,3750,1525,2225,491,98,69,29,0,0,0,0,970,93,35,58,167,7,0,7,46,7,0,7,301,4,4,0
64,120299,14256,6773,7483,0500000US01125,1125,"Tuscaloosa County, Alabama",Tuscaloosa County, Alabama,65458,16681,7031,9650,3189,774,394,380,21,0,0,0,7414,1765,537,1228,3293,830,398,432,446,148,43,105,1750,547,91,456
65,55265,8392,3417,4975,0500000US01127,1127,"Walker County, Alabama",Walker County, Alabama,3699,1014,410,604,1691,593,283,310,0,0,0,0,1650,651,394,257,238,0,0,0,188,0,0,0,652,335,217,118
66,10542,1183,515,668,0500000US01129,1129,"Washington County, Alabama",Washington County, Alabama,3935,884,470,414,315,105,45,60,0,0,0,0,140,118,21,97,30,20,4,16,1223,94,71,23,25,0,0,0
67,2737,147,73,74,0500000US01131,1131,"Wilcox County, Alabama",Wilcox County, Alabama,7244,2657,1000,1657,250,33,10,23,0,0,0,0,46,5,0,5,4,0,0,0,12,4,0,4,0,0,0,0
68,21831,3727,1326,2401,0500000US01133,1133,"Winston County, Alabama",Winston County, Alabama,158,44,39,5,414,157,75,82,16,0,0,0,737,133,49,84,89,0,0,0,71,0,0,0,261,101,40,61
69,447,35,35,0,0500000US02013,2013,"Aleutians East Borough, Alaska",Aleutians East Borough, Alaska,128,9,0,9,377,17,6,11,11,11,4,7,295,33,5,28,815,52,7,45,1377,255,147,108,175,23,0,23
70,1145,57,31,26,0500000US02016,2016,"Aleutians West Census Area, Alaska",Aleutians West Census Area, Alaska,136,7,7,0,575,57,55,2,164,55,30,25,755,86,73,13,2337,107,71,36,593,98,68,30,293,20,10,10
71,162163,9295,4169,5126,0500000US02020,2020,"Anchorage Municipality, Alaska",Anchorage Municipality, Alaska,14921,1737,802,935,31247,2977,1556,1421,8210,1402,626,776,26710,2651,1303,1348,28412,3252,1251,2001,20816,4896,2624,2272,6629,661,310,351
72,1658,45,20,25,0500000US02050,2050,"Bethel Census Area, Alaska",Bethel Census Area, Alaska,131,11,11,0,700,148,88,60,44,0,0,0,344,61,58,3,203,41,1,40,14941,4866,2504,2362,44,0,0,0
73,347,10,4,6,0500000US02060,2060,"Bristol Bay Borough, Alaska",Bristol Bay Borough, Alaska,0,0,0,0,78,3,3,0,9,0,0,0,72,0,0,0,17,0,0,0,214,23,7,16,21,0,0,0
74,4703,206,119,87,0500000US02063,2063,"Chugach Census Area, Alaska",Chugach Census Area, Alaska,57,0,0,0,473,76,0,76,62,17,12,5,328,2,2,0,370,9,6,3,397,20,1,19,196,2,2,0
75,1637,104,59,45,0500000US02066,2066,"Copper River Census Area, Alaska",Copper River Census Area, Alaska,5,0,0,0,381,16,5,11,0,0,0,0,124,0,0,0,13,0,0,0,821,148,82,66,7,0,0,0
76,1985,232,138,94,0500000US02068,2068,"Denali Borough, Alaska",Denali Borough, Alaska,44,39,25,14,308,60,56,4,0,0,0,0,31,0,0,0,51,14,8,6,43,0,0,0,10,0,0,0
77,722,47,31,16,0500000US02070,2070,"Dillingham Census Area, Alaska",Dillingham Census Area, Alaska,73,0,0,0,326,41,14,27,3,0,0,0,148,25,7,18,20,0,0,0,3627,749,383,366,34,0,0,0
78,65329,3621,1666,1955,0500000US02090,2090,"Fairbanks North Star Borough, Alaska",Fairbanks North Star Borough, Alaska,4055,432,176,256,7694,698,381,317,518,36,0,36,7485,700,408,292,2999,89,55,34,7308,878,335,543,1647,54,29,25
79,1820,245,131,114,0500000US02100,2100,"Haines Borough, Alaska",Haines Borough, Alaska,0,0,0,0,368,28,28,0,4,0,0,0,132,22,0,22,45,3,3,0,142,19,6,13,1,0,0,0
80,973,59,30,29,0500000US02105,2105,"Hoonah-Angoon Census Area, Alaska",Hoonah-Angoon Census Area, Alaska,72,0,0,0,235,13,4,9,0,0,0,0,198,6,5,1,49,0,0,0,711,124,66,58,21,0,0,0
81,20200,853,463,390,0500000US02110,2110,"Juneau City and Borough, Alaska",Juneau City and Borough, Alaska,251,12,10,2,4190,598,227,371,371,52,48,4,2177,426,187,239,2165,154,52,102,3096,433,265,168,442,0,0,0
82,45909,5304,2568,2736,0500000US02122,2122,"Kenai Peninsula Borough, Alaska",Kenai Peninsula Borough, Alaska,287,65,24,41,3784,623,314,309,172,8,5,3,2464,420,170,250,963,142,49,93,4266,894,450,444,872,69,36,33
83,8624,482,245,237,0500000US02130,2130,"Ketchikan Gateway Borough, Alaska",Ketchikan Gateway Borough, Alaska,94,25,13,12,1317,156,91,65,24,6,0,6,739,43,25,18,1145,60,18,42,2005,424,144,280,191,39,23,16
84,6266,256,153,103,0500000US02150,2150,"Kodiak Island Borough, Alaska",Kodiak Island Borough, Alaska,45,14,0,14,1246,109,72,37,31,0,0,0,1174,36,14,22,3055,114,16,98,1618,454,174,280,158,11,11,0
85,264,2,2,0,0500000US02158,2158,"Kusilvak Census Area, Alaska",Kusilvak Census Area, Alaska,37,4,4,0,195,35,16,19,6,6,6,0,94,13,0,13,7,3,3,0,7653,3050,1579,1471,58,13,0,13
86,273,15,14,1,0500000US02164,2164,"Lake and Peninsula Borough, Alaska",Lake and Peninsula Borough, Alaska,80,0,0,0,86,3,1,2,3,3,3,0,3,0,0,0,26,0,0,0,673,156,71,85,1,0,0,0
87,83157,8219,3907,4312,0500000US02170,2170,"Matanuska-Susitna Borough, Alaska",Matanuska-Susitna Borough, Alaska,1402,99,79,20,8693,898,475,423,278,42,8,34,5528,592,254,338,1570,197,65,132,5880,863,496,367,647,67,12,55
88,1340,26,8,18,0500000US02180,2180,"Nome Census Area, Alaska",Nome Census Area, Alaska,70,8,2,6,465,31,11,20,2,0,0,0,187,9,5,4,261,0,0,0,7386,2086,1090,996,12,0,0,0
89,2607,107,85,22,0500000US02185,2185,"North Slope Borough, Alaska",North Slope Borough, Alaska,146,0,0,0,733,35,17,18,203,0,0,0,344,0,0,0,545,0,0,0,4843,727,317,410,128,0,0,0
90,796,16,15,1,0500000US02188,2188,"Northwest Arctic Borough, Alaska",Northwest Arctic Borough, Alaska,78,1,1,0,304,21,11,10,8,8,5,3,191,0,0,0,91,7,7,0,6262,1720,897,823,17,0,0,0
91,1978,62,22,40,0500000US02195,2195,"Petersburg Borough, Alaska",Petersburg Borough, Alaska,66,8,7,1,284,17,10,7,6,3,0,3,254,8,2,6,473,16,1,15,223,44,11,33,12,3,3,0
92,2837,430,251,179,0500000US02198,2198,"Prince of Wales-Hyder Census Area, Alaska",Prince of Wales-Hyder Census Area, Alaska,35,3,3,0,668,101,56,45,40,30,12,18,243,35,12,23,98,0,0,0,2444,578,334,244,17,0,0,0
93,5142,153,75,78,0500000US02220,2220,"Sitka City and Borough, Alaska",Sitka City and Borough, Alaska,52,18,0,18,1250,135,67,68,13,0,0,0,572,63,22,41,651,36,15,21,966,189,76,113,58,5,3,2
94,996,66,34,32,0500000US02230,2230,"Skagway Municipality, Alaska",Skagway Municipality, Alaska,58,2,2,0,117,1,0,1,0,0,0,0,50,3,0,3,34,0,0,0,59,3,0,3,3,0,0,0
95,4960,361,175,186,0500000US02240,2240,"Southeast Fairbanks Census Area, Alaska",Southeast Fairbanks Census Area, Alaska,68,0,0,0,284,34,28,6,14,0,0,0,449,33,19,14,194,0,0,0,963,261,166,95,173,0,0,0
96,1602,92,37,55,0500000US02275,2275,"Wrangell City and Borough, Alaska",Wrangell City and Borough, Alaska,8,0,0,0,208,6,4,2,32,22,17,5,97,12,7,5,42,0,0,0,564,68,30,38,10,0,0,0
97,193,23,10,13,0500000US02282,2282,"Yakutat City and Borough, Alaska",Yakutat City and Borough, Alaska,34,0,0,0,99,0,0,0,2,0,0,0,93,0,0,0,50,13,13,0,172,4,2,2,10,0,0,0
98,1096,134,25,109,0500000US02290,2290,"Yukon-Koyukuk Census Area, Alaska",Yukon-Koyukuk Census Area, Alaska,4,0,0,0,364,117,48,69,2,2,0,2,132,28,10,18,32,7,3,4,3692,968,530,438,10,6,0,6
99,12540,1552,734,818,0500000US04001,4001,"Apache County, Arizona",Apache County, Arizona,421,95,24,71,1719,640,386,254,55,0,0,0,4401,1052,567,485,252,36,4,32,52248,21241,10318,10923,508,98,66,32
100,65591,7471,3270,4201,0500000US04003,4003,"Cochise County, Arizona",Cochise County, Arizona,4259,350,207,143,9848,1623,758,865,340,85,41,44,42536,9177,4083,5094,2294,243,94,149,1230,357,125,232,2719,658,318,340
101,68262,8897,4782,4115,0500000US04005,4005,"Coconino County, Arizona",Coconino County, Arizona,1197,296,154,142,5568,638,335,303,136,35,35,0,17740,2638,1177,1461,2379,469,208,261,36430,9637,4473,5164,3342,400,126,274
102,32926,4703,1891,2812,0500000US04007,4007,"Gila County, Arizona",Gila County, Arizona,317,206,51,155,2624,674,358,316,32,32,32,0,9877,1721,1017,704,446,0,0,0,8487,3869,1881,1988,1687,120,56,64
103,18363,3174,1333,1841,0500000US04009,4009,"Graham County, Arizona",Graham County, Arizona,271,57,56,1,1951,406,131,275,9,0,0,0,10869,2243,956,1287,231,2,1,1,4532,1814,780,1034,484,48,19,29
104,4334,681,293,388,0500000US04011,4011,"Greenlee County, Arizona",Greenlee County, Arizona,175,19,19,0,456,61,39,22,0,0,0,0,4429,408,178,230,38,0,0,0,346,118,34,84,128,33,29,4
105,11835,2067,1125,942,0500000US04012,4012,"La Paz County, Arizona",La Paz County, Arizona,193,12,12,0,1147,151,45,106,4,0,0,0,5794,1517,518,999,171,0,0,0,3000,1277,453,824,853,197,87,110
106,2379393,195962,89983,105979,0500000US04013,4013,"Maricopa County, Arizona",Maricopa County, Arizona,244453,47616,22080,25536,308622,45112,22335,22777,9546,1070,569,501,1354993,258734,118336,140398,185411,20009,9913,10096,82602,18269,8040,10229,302952,62655,28188,34467
107,159543,23710,10587,13123,0500000US04015,4015,"Mohave County, Arizona",Mohave County, Arizona,1722,559,328,231,9381,2420,1549,871,470,4,4,0,34193,6625,3665,2960,2483,221,32,189,4178,1327,643,684,6366,1094,470,624
108,45265,5671,2681,2990,0500000US04017,4017,"Navajo County, Arizona",Navajo County, Arizona,902,306,227,79,3730,1049,530,519,162,43,16,27,11586,3191,1387,1804,521,199,109,90,47422,17406,8097,9309,3089,969,359,610
109,518307,58059,27475,30584,0500000US04019,4019,"Pima County, Arizona",Pima County, Arizona,33418,7656,4111,3545,79498,13566,6077,7489,1711,650,264,386,379991,77882,33899,43983,29315,4617,2318,2299,35182,11469,5028,6441,85288,19049,7806,11243
110,243857,23182,10419,12763,0500000US04021,4021,"Pinal County, Arizona",Pinal County, Arizona,16759,2842,1137,1705,29473,3423,2091,1332,858,125,113,12,124524,17460,8414,9046,7005,794,316,478,19723,6022,2908,3114,19737,2923,1236,1687
111,6827,648,306,342,0500000US04023,4023,"Santa Cruz County, Arizona",Santa Cruz County, Arizona,353,107,80,27,4953,1161,756,405,0,0,0,0,38720,9195,4385,4810,188,0,0,0,282,98,12,86,4319,958,257,701
112,182854,21619,10498,11121,0500000US04025,4025,"Yavapai County, Arizona",Yavapai County, Arizona,1350,223,194,29,9308,1989,926,1063,142,0,0,0,33025,4395,2063,2332,2134,323,152,171,2873,1026,330,696,7615,1021,482,539
113,62480,7209,3220,3989,0500000US04027,4027,"Yuma County, Arizona",Yuma County, Arizona,3692,710,478,232,22523,3277,1139,2138,94,12,12,0,132789,28283,12333,15950,2469,184,92,92,2834,1127,643,484,29825,5782,2477,3305
114,11997,1337,663,674,0500000US05001,5001,"Arkansas County, Arkansas",Arkansas County, Arkansas,4397,1231,448,783,371,188,2,186,0,0,0,0,591,25,14,11,10,0,0,0,102,0,0,0,119,23,12,11
115,13477,1848,814,1034,0500000US05003,5003,"Ashley County, Arkansas",Ashley County, Arkansas,4937,1269,633,636,224,73,17,56,92,0,0,0,1120,53,48,5,34,0,0,0,2,0,0,0,218,0,0,0
116,38363,4821,2260,2561,0500000US05005,5005,"Baxter County, Arkansas",Baxter County, Arkansas,52,35,27,8,1262,260,133,127,17,0,0,0,1009,98,68,30,164,1,0,1,208,11,2,9,358,2,2,0
117,189315,14694,6155,8539,0500000US05007,5007,"Benton County, Arkansas",Benton County, Arkansas,4049,429,224,205,21125,1721,1029,692,1802,411,211,200,45594,5726,3036,2690,10831,590,254,336,3248,661,230,431,7830,568,347,221
118,34567,4623,2048,2575,0500000US05009,5009,"Boone County, Arkansas",Boone County, Arkansas,52,44,8,36,854,221,90,131,0,0,0,0,953,156,44,112,274,4,0,4,251,20,6,14,103,7,4,3
119,5916,440,172,268,0500000US05011,5011,"Bradley County, Arkansas",Bradley County, Arkansas,2942,884,274,610,183,5,0,5,0,0,0,0,1662,353,106,247,7,0,0,0,357,0,0,0,61,0,0,0
120,3630,274,159,115,0500000US05013,5013,"Calhoun County, Arkansas",Calhoun County, Arkansas,1130,234,124,110,135,120,87,33,15,0,0,0,216,99,70,29,0,0,0,0,0,0,0,0,1,0,0,0
121,21715,2569,1216,1353,0500000US05015,5015,"Carroll County, Arkansas",Carroll County, Arkansas,224,89,31,58,1276,320,246,74,277,227,121,106,4231,955,454,501,384,32,17,15,338,163,4,159,475,81,25,56
122,3605,494,248,246,0500000US05017,5017,"Chicot County, Arkansas",Chicot County, Arkansas,5431,1960,825,1135,226,41,22,19,0,0,0,0,573,264,89,175,63,0,0,0,0,0,0,0,42,0,0,0
123,13717,2008,747,1261,0500000US05019,5019,"Clark County, Arkansas",Clark County, Arkansas,4823,1625,581,1044,347,179,92,87,0,0,0,0,889,312,171,141,128,52,33,19,44,1,0,1,545,282,162,120
124,13806,2626,1044,1582,0500000US05021,5021,"Clay County, Arkansas",Clay County, Arkansas,35,0,0,0,316,190,91,99,0,0,0,0,325,149,138,11,4,0,0,0,57,5,0,5,208,122,122,0
125,23207,3216,1481,1735,0500000US05023,5023,"Cleburne County, Arkansas",Cleburne County, Arkansas,194,104,67,37,437,3,3,0,0,0,0,0,603,183,75,108,83,0,0,0,222,22,0,22,7,0,0,0
126,6737,803,332,471,0500000US05025,5025,"Cleveland County, Arkansas",Cleveland County, Arkansas,1068,347,146,201,146,23,0,23,0,0,0,0,0,0,0,0,0,0,0,0,23,0,0,0,0,0,0,0
127,13038,1836,727,1109,0500000US05027,5027,"Columbia County, Arkansas",Columbia County, Arkansas,7791,3212,1249,1963,192,67,18,49,0,0,0,0,606,170,37,133,161,19,19,0,22,0,0,0,176,76,0,76
128,16908,3126,1590,1536,0500000US05029,5029,"Conway County, Arkansas",Conway County, Arkansas,2105,393,67,326,783,271,144,127,0,0,0,0,841,348,146,202,102,0,0,0,90,15,15,0,3,0,0,0
129,78405,9315,4094,5221,0500000US05031,5031,"Craighead County, Arkansas",Craighead County, Arkansas,16022,6189,1878,4311,3671,670,383,287,0,0,0,0,5458,1690,892,798,1409,461,360,101,190,116,34,82,2179,920,730,190
130,52163,9057,4144,4913,0500000US05033,5033,"Crawford County, Arkansas",Crawford County, Arkansas,773,114,32,82,2589,478,189,289,16,0,0,0,4967,1348,647,701,1030,101,0,101,1211,84,49,35,1861,695,335,360
131,19524,2138,797,1341,0500000US05035,5035,"Crittenden County, Arkansas",Crittenden County, Arkansas,23206,6883,2723,4160,3575,730,330,400,22,0,0,0,1263,393,242,151,355,35,4,31,87,0,0,0,100,66,43,23
132,11771,1848,711,1137,0500000US05037,5037,"Cross County, Arkansas",Cross County, Arkansas,2914,524,197,327,1315,391,94,297,0,0,0,0,335,41,0,41,7,7,7,0,32,32,32,0,10,0,0,0
133,3295,375,138,237,0500000US05039,5039,"Dallas County, Arkansas",Dallas County, Arkansas,2917,479,182,297,105,2,0,2,28,0,0,0,34,0,0,0,0,0,0,0,0,0,0,0,0,0,0,0
134,5077,602,303,299,0500000US05041,5041,"Desha County, Arkansas",Desha County, Arkansas,5442,2005,839,1166,174,33,3,30,0,0,0,0,734,260,154,106,46,23,0,23,40,0,0,0,176,0,0,0
135,11535,1925,855,1070,0500000US05043,5043,"Drew County, Arkansas",Drew County, Arkansas,4780,1255,530,725,314,120,106,14,0,0,0,0,564,205,101,104,5,0,0,0,0,0,0,0,155,0,0,0
136,95767,12731,5516,7215,0500000US05045,5045,"Faulkner County, Arkansas",Faulkner County, Arkansas,13425,3241,1536,1705,3938,640,287,353,167,158,94,64,4963,1844,921,923,1332,344,119,225,433,4,4,0,2236,883,477,406
137,16011,3296,1574,1722,0500000US05047,5047,"Franklin County, Arkansas",Franklin County, Arkansas,86,59,49,10,386,63,37,26,59,0,0,0,566,315,115,200,133,3,0,3,287,188,21,167,171,15,15,0
138,11440,2361,1096,1265,0500000US05049,5049,"Fulton County, Arkansas",Fulton County, Arkansas,29,27,13,14,454,64,21,43,26,26,0,26,70,6,6,0,16,0,0,0,112,35,18,17,9,0,0,0
139,79355,10471,4360,6111,0500000US05051,5051,"Garland County, Arkansas",Garland County, Arkansas,7907,3730,1833,1897,2913,926,406,520,39,38,0,38,5634,1069,604,465,802,147,66,81,955,236,126,110,1736,161,84,77
140,16616,2037,1064,973,0500000US05053,5053,"Grant County, Arkansas",Grant County, Arkansas,454,171,54,117,500,1,0,1,29,0,0,0,518,87,70,17,0,0,0,0,20,0,0,0,72,0,0,0
141,40795,6052,2724,3328,0500000US05055,5055,"Greene County, Arkansas",Greene County, Arkansas,955,687,302,385,1000,434,200,234,21,21,21,0,1191,69,44,25,164,23,15,8,122,9,0,9,331,19,0,19
142,11604,1165,435,730,0500000US05057,5057,"Hempstead County, Arkansas",Hempstead County, Arkansas,6452,2057,734,1323,525,87,0,87,73,0,0,0,2785,1381,423,958,28,16,10,6,119,16,0,16,2150,1272,417,855
143,26586,3403,1705,1698,0500000US05059,5059,"Hot Spring County, Arkansas",Hot Spring County, Arkansas,3007,865,402,463,678,33,9,24,0,0,0,0,1066,445,248,197,54,15,9,6,85,58,0,58,241,0,0,0
144,8318,978,348,630,0500000US05061,5061,"Howard County, Arkansas",Howard County, Arkansas,2665,1027,452,575,335,29,8,21,17,0,0,0,1680,481,223,258,116,0,0,0,57,0,0,0,1218,362,166,196
145,32225,4410,2235,2175,0500000US05063,5063,"Independence County, Arkansas",Independence County, Arkansas,593,71,40,31,1400,264,157,107,0,0,0,0,2414,777,310,467,304,10,0,10,91,35,1,34,1197,365,194,171
146,11780,1704,797,907,0500000US05065,5065,"Izard County, Arkansas",Izard County, Arkansas,0,0,0,0,509,127,0,127,0,0,0,0,279,0,0,0,0,0,0,0,112,79,21,58,23,0,0,0
147,11002,2065,904,1161,0500000US05067,5067,"Jackson County, Arkansas",Jackson County, Arkansas,1359,509,269,240,1798,617,347,270,2,2,0,2,427,238,170,68,0,0,0,0,0,0,0,0,19,14,14,0
148,23089,3106,1369,1737,0500000US05069,5069,"Jefferson County, Arkansas",Jefferson County, Arkansas,34994,8776,3683,5093,1307,496,323,173,358,0,0,0,1300,460,198,262,647,19,8,11,142,31,31,0,608,347,165,182
149,20451,3601,1378,2223,0500000US05071,5071,"Johnson County, Arkansas",Johnson County, Arkansas,325,52,39,13,1265,148,126,22,23,0,0,0,3633,804,211,593,570,33,15,18,47,29,29,0,488,213,13,200
150,3804,600,299,301,0500000US05073,5073,"Lafayette County, Arkansas",Lafayette County, Arkansas,2375,966,436,530,106,55,47,8,0,0,0,0,196,0,0,0,50,0,0,0,20,0,0,0,110,0,0,0
151,15040,2123,830,1293,0500000US05075,5075,"Lawrence County, Arkansas",Lawrence County, Arkansas,131,53,31,22,536,48,42,6,2,0,0,0,243,12,12,0,11,0,0,0,32,7,3,4,25,0,0,0
152,2900,355,140,215,0500000US05077,5077,"Lee County, Arkansas",Lee County, Arkansas,4199,1563,568,995,58,36,19,17,0,0,0,0,202,39,21,18,6,0,0,0,13,13,0,13,26,3,0,3
153,6313,1148,484,664,0500000US05079,5079,"Lincoln County, Arkansas",Lincoln County, Arkansas,1528,404,111,293,103,29,18,11,0,0,0,0,258,29,11,18,0,0,0,0,24,12,0,12,150,0,0,0
154,8787,706,332,374,0500000US05081,5081,"Little River County, Arkansas",Little River County, Arkansas,2322,709,208,501,348,155,84,71,0,0,0,0,455,125,17,108,41,0,0,0,133,21,3,18,232,42,17,25
155,18897,2960,1350,1610,0500000US05083,5083,"Logan County, Arkansas",Logan County, Arkansas,293,85,42,43,1086,210,86,124,0,0,0,0,628,154,91,63,344,94,10,84,175,57,21,36,166,14,14,0
156,61848,6792,3113,3679,0500000US05085,5085,"Lonoke County, Arkansas",Lonoke County, Arkansas,3952,1134,515,619,2487,189,20,169,157,46,18,28,3304,485,242,243,709,12,12,0,350,15,15,0,844,233,83,150
157,14376,2507,1167,1340,0500000US05087,5087,"Madison County, Arkansas",Madison County, Arkansas,0,0,0,0,633,52,38,14,102,0,0,0,955,183,60,123,125,2,0,2,132,104,33,71,231,17,5,12
158,15319,2707,1170,1537,0500000US05089,5089,"Marion County, Arkansas",Marion County, Arkansas,104,104,58,46,299,105,24,81,0,0,0,0,392,111,9,102,96,10,0,10,171,37,9,28,12,0,0,0
159,28710,3774,1882,1892,0500000US05091,5091,"Miller County, Arkansas",Miller County, Arkansas,10500,3051,1035,2016,799,188,111,77,42,30,16,14,1422,354,123,231,126,0,0,0,564,164,84,80,621,200,55,145
160,23300,3511,1402,2109,0500000US05093,5093,"Mississippi County, Arkansas",Mississippi County, Arkansas,14142,4489,2056,2433,1203,203,149,54,34,20,0,20,1765,430,136,294,195,13,0,13,9,0,0,0,483,30,8,22
161,3662,433,155,278,0500000US05095,5095,"Monroe County, Arkansas",Monroe County, Arkansas,2864,1050,441,609,127,42,11,31,0,0,0,0,75,31,5,26,16,0,0,0,47,0,0,0,31,31,5,26
162,8021,1222,539,683,0500000US05097,5097,"Montgomery County, Arkansas",Montgomery County, Arkansas,16,8,3,5,263,189,96,93,0,0,0,0,384,194,96,98,34,0,0,0,98,24,7,17,273,169,85,84
163,4955,500,216,284,0500000US05099,5099,"Nevada County, Arkansas",Nevada County, Arkansas,2869,1143,669,474,190,73,1,72,1,0,0,0,1,0,0,0,5,0,0,0,21,0,0,0,0,0,0,0
164,7150,772,422,350,0500000US05101,5101,"Newton County, Arkansas",Newton County, Arkansas,0,0,0,0,297,31,9,22,34,0,0,0,72,9,9,0,8,0,0,0,135,3,0,3,57,0,0,0
165,12732,1986,824,1162,0500000US05103,5103,"Ouachita County, Arkansas",Ouachita County, Arkansas,9931,2895,1150,1745,191,8,8,0,0,0,0,0,553,157,83,74,10,5,0,5,0,0,0,0,29,0,0,0
166,9393,1561,738,823,0500000US05105,5105,"Perry County, Arkansas",Perry County, Arkansas,265,14,3,11,294,47,33,14,0,0,0,0,304,40,30,10,6,0,0,0,14,1,1,0,167,0,0,0
167,6084,665,239,426,0500000US05107,5107,"Phillips County, Arkansas",Phillips County, Arkansas,11487,4903,2111,2792,180,32,9,23,0,0,0,0,350,51,23,28,0,0,0,0,9,9,9,0,53,9,0,9
168,9125,1294,503,791,0500000US05109,5109,"Pike County, Arkansas",Pike County, Arkansas,364,228,133,95,327,63,31,32,0,0,0,0,665,179,109,70,21,1,0,1,48,8,8,0,372,161,104,57
169,19863,3468,1417,2051,0500000US05111,5111,"Poinsett County, Arkansas",Poinsett County, Arkansas,850,407,215,192,1832,606,236,370,0,0,0,0,751,350,198,152,11,9,8,1,18,0,0,0,256,210,131,79
170,17170,3641,1568,2073,0500000US05113,5113,"Polk County, Arkansas",Polk County, Arkansas,90,18,14,4,735,129,44,85,21,0,0,0,1307,481,177,304,61,0,0,0,319,93,70,23,702,245,137,108
171,50778,7996,3153,4843,0500000US05115,5115,"Pope County, Arkansas",Pope County, Arkansas,1308,228,92,136,2221,426,186,240,0,0,0,0,5722,829,423,406,651,106,0,106,316,23,15,8,1730,125,70,55
172,6720,558,205,353,0500000US05117,5117,"Prairie County, Arkansas",Prairie County, Arkansas,901,228,96,132,139,18,10,8,0,0,0,0,144,0,0,0,14,0,0,0,10,10,0,10,40,8,8,0
173,199233,17787,8182,9605,0500000US05119,5119,"Pulaski County, Arkansas",Pulaski County, Arkansas,142963,35203,14699,20504,12868,1832,833,999,258,86,5,81,23691,5337,2488,2849,8558,1057,476,581,1374,387,172,215,9365,2650,1270,1380
174,16178,3087,1412,1675,0500000US05121,5121,"Randolph County, Arkansas",Randolph County, Arkansas,103,32,19,13,634,141,80,61,107,33,20,13,381,30,30,0,58,16,12,4,60,0,0,0,135,0,0,0
175,8753,1902,911,991,0500000US05123,5123,"St. Francis County, Arkansas",St. Francis County, Arkansas,11782,3884,1535,2349,837,436,377,59,41,41,27,14,1055,425,381,44,157,0,0,0,54,10,1,9,409,8,8,0
176,99768,7749,3687,4062,0500000US05125,5125,"Saline County, Arkansas",Saline County, Arkansas,8941,1020,540,480,3044,452,132,320,110,0,0,0,5979,808,360,448,1442,16,0,16,334,3,0,3,1248,113,34,79
177,8576,1708,785,923,0500000US05127,5127,"Scott County, Arkansas",Scott County, Arkansas,217,0,0,0,477,8,8,0,0,0,0,0,808,56,56,0,141,0,0,0,37,0,0,0,458,0,0,0
178,7101,1692,664,1028,0500000US05129,5129,"Searcy County, Arkansas",Searcy County, Arkansas,0,0,0,0,379,157,35,122,0,0,0,0,209,108,71,37,28,0,0,0,263,166,109,57,9,0,0,0
179,86854,11177,4559,6618,0500000US05131,5131,"Sebastian County, Arkansas",Sebastian County, Arkansas,7700,2561,1145,1416,7934,1738,800,938,14,0,0,0,18227,5274,2763,2511,5782,697,369,328,1324,300,150,150,12464,3605,1900,1705
180,9549,1514,625,889,0500000US05133,5133,"Sevier County, Arkansas",Sevier County, Arkansas,768,241,120,121,426,77,66,11,82,82,45,37,5634,1384,522,862,82,0,0,0,454,11,4,7,4559,1207,405,802
181,15552,2840,1274,1566,0500000US05135,5135,"Sharp County, Arkansas",Sharp County, Arkansas,156,28,4,24,806,62,17,45,0,0,0,0,412,144,53,91,3,3,0,3,29,11,6,5,53,4,4,0
182,11591,2158,946,1212,0500000US05137,5137,"Stone County, Arkansas",Stone County, Arkansas,2,2,2,0,536,273,162,111,0,0,0,0,240,90,51,39,64,8,0,8,45,14,0,14,90,90,51,39
183,23437,2297,996,1301,0500000US05139,5139,"Union County, Arkansas",Union County, Arkansas,12773,4319,1971,2348,382,116,57,59,0,0,0,0,1558,691,282,409,302,62,0,62,286,136,3,133,164,35,10,25
184,15188,2465,1158,1307,0500000US05141,5141,"Van Buren County, Arkansas",Van Buren County, Arkansas,76,47,38,9,436,41,16,25,14,0,0,0,529,158,87,71,22,0,0,0,212,0,0,0,139,90,30,60
185,157990,20706,10060,10646,0500000US05143,5143,"Washington County, Arkansas",Washington County, Arkansas,7041,1543,497,1046,14098,3364,1393,1971,6209,1492,756,736,39608,9113,4143,4970,6057,942,428,514,1804,319,197,122,21715,4430,1939,2491
186,65835,8497,3521,4976,0500000US05145,5145,"White County, Arkansas",White County, Arkansas,3058,712,292,420,2110,411,210,201,0,0,0,0,3423,973,463,510,614,194,90,104,355,64,44,20,616,339,198,141
187,4296,678,250,428,0500000US05147,5147,"Woodruff County, Arkansas",Woodruff County, Arkansas,1862,696,308,388,62,9,0,9,0,0,0,0,15,15,0,15,0,0,0,0,0,0,0,0,0,0,0,0
188,15788,2044,797,1247,0500000US05149,5149,"Yell County, Arkansas",Yell County, Arkansas,391,150,108,42,347,9,1,8,0,0,0,0,4390,862,472,390,261,50,31,19,83,45,0,45,3615,734,400,334
189,500807,33893,15358,18535,0500000US06001,6001,"Alameda County, California",Alameda County, California,168213,30740,12951,17789,128751,11213,4956,6257,13494,1252,477,775,362865,40292,17941,22351,512341,38691,17304,21387,10782,1517,639,878,181387,23693,11004,12689
190,595,32,27,5,0500000US06003,6003,"Alpine County, California",Alpine County, California,10,10,5,5,111,3,3,0,4,0,0,0,183,30,18,12,6,6,5,1,360,81,37,44,5,0,0,0
191,28743,2294,1076,1218,0500000US06005,6005,"Amador County, California",Amador County, California,62,20,2,18,2577,338,39,299,28,0,0,0,4304,198,112,86,313,36,31,5,173,53,31,22,858,67,60,7
192,155426,25206,11914,13292,0500000US06007,6007,"Butte County, California",Butte County, California,3686,1395,441,954,15066,3403,1771,1632,704,164,80,84,36453,7708,3877,3831,10441,2755,1326,1429,2534,302,79,223,10805,2429,1144,1285
193,36555,3871,2088,1783,0500000US06009,6009,"Calaveras County, California",Calaveras County, California,392,22,6,16,2902,396,88,308,13,7,7,0,5598,788,462,326,859,38,11,27,516,36,0,36,960,138,54,84
194,7423,1115,562,553,0500000US06011,6011,"Colusa County, California",Colusa County, California,289,64,35,29,2299,203,96,107,32,0,0,0,12772,1218,474,744,180,66,31,35,239,30,11,19,1369,118,75,43
195,485605,25933,11660,14273,0500000US06013,6013,"Contra Costa County, California",Contra Costa County, California,97209,13154,5868,7286,103951,10260,4566,5694,5577,526,154,372,292815,35282,15467,19815,199218,11841,4885,6956,5099,360,116,244,123187,17190,7330,9860
196,16270,2330,874,1456,0500000US06015,6015,"Del Norte County, California",Del Norte County, California,273,77,0,77,2079,353,146,207,27,0,0,0,3965,594,309,285,754,353,190,163,1813,606,337,269,1856,257,108,149
197,146037,11286,4918,6368,0500000US06017,6017,"El Dorado County, California",El Dorado County, California,1438,286,116,170,8434,767,472,295,479,38,0,38,24302,3325,1588,1737,9053,382,130,252,1275,228,149,79,4534,353,224,129
198,279141,32205,14161,18044,0500000US06019,6019,"Fresno County, California",Fresno County, California,44494,13652,6598,7054,82904,15547,7733,7814,1442,422,185,237,519842,133315,61361,71954,104287,18766,8701,10065,11246,3021,1542,1479,140727,36652,17027,19625
199,14212,1776,648,1128,0500000US06021,6021,"Glenn County, California",Glenn County, California,147,37,8,29,855,231,148,83,12,0,0,0,11669,1788,647,1141,876,297,188,109,585,181,59,122,2924,647,204,443
200,98367,16677,7881,8796,0500000US06023,6023,"Humboldt County, California",Humboldt County, California,1358,675,365,310,10239,2392,1298,1094,504,261,71,190,15182,3483,1674,1809,3789,1076,487,589,6049,2150,1153,997,5737,1457,775,682
201,17570,2155,1053,1102,0500000US06025,6025,"Imperial County, California",Imperial County, California,2652,759,413,346,18624,3596,1431,2165,209,52,16,36,146169,34979,14767,20212,2363,181,87,94,1929,705,268,437,43523,10667,4705,5962
202,10808,737,481,256,0500000US06027,6027,"Inyo County, California",Inyo County, California,58,8,0,8,1380,105,71,34,37,15,8,7,4013,712,430,282,258,8,3,5,1846,222,90,132,432,32,12,20
203,289667,41474,19191,22283,0500000US06029,6029,"Kern County, California",Kern County, California,42594,14264,6485,7779,71605,13832,6206,7626,1249,517,240,277,464865,110106,48653,61453,42522,6541,2890,3651,8068,2060,716,1344,109855,25370,11131,14239
204,44065,3710,1520,2190,0500000US06031,6031,"Kings County, California",Kings County, California,6578,1158,627,531,11931,1501,642,859,113,6,0,6,76317,16055,7499,8556,5359,388,183,205,1862,380,245,135,20576,4153,1876,2277
205,43624,6871,3078,3793,0500000US06033,6033,"Lake County, California",Lake County, California,1531,571,339,232,3115,697,235,462,10,10,8,2,13485,2175,790,1385,888,163,77,86,2503,849,463,386,7218,1568,589,979
206,17383,2105,1056,1049,0500000US06035,6035,"Lassen County, California",Lassen County, California,419,49,30,19,806,127,39,88,247,19,19,0,1564,203,143,60,213,24,18,6,575,258,107,151,633,13,13,0
207,2554426,239696,110008,129688,0500000US06037,6037,"Los Angeles County, California",Los Angeles County, California,787711,158947,72861,86086,717876,86955,40085,46870,24520,2618,1127,1491,4797018,811959,363778,448181,1464802,161028,69856,91172,76403,12461,5668,6793,2093575,372864,166243,206621
208,49612,5280,2128,3152,0500000US06039,6039,"Madera County, California",Madera County, California,3587,924,251,673,10900,829,350,479,140,2,2,0,87126,20455,9210,11245,3082,735,361,374,2251,476,157,319,35905,10689,4959,5730
209,181252,8562,3731,4831,0500000US06041,6041,"Marin County, California",Marin County, California,5060,651,375,276,16888,1280,570,710,330,9,0,9,39991,6286,2918,3368,14494,1087,402,685,596,139,43,96,19646,4464,2200,2264
210,13586,1938,994,944,0500000US06043,6043,"Mariposa County, California",Mariposa County, California,237,109,12,97,750,146,30,116,62,0,0,0,1962,351,184,167,182,46,36,10,392,78,33,45,494,62,3,59
211,55163,6951,3020,3931,0500000US06045,6045,"Mendocino County, California",Mendocino County, California,334,133,61,72,6418,1540,721,819,137,0,0,0,21950,4982,2823,2159,1583,215,56,159,3728,796,293,503,4579,1186,643,543
212,72340,9163,3688,5475,0500000US06047,6047,"Merced County, California",Merced County, California,7255,1727,799,928,16455,2697,1198,1499,742,50,34,16,161358,34558,15257,19301,20355,3382,1558,1824,2789,943,362,581,82223,19060,8986,10074
213,6753,1003,435,568,0500000US06049,6049,"Modoc County, California",Modoc County, California,93,48,47,1,189,44,21,23,0,0,0,0,1205,211,106,105,162,131,121,10,297,117,25,92,187,39,9,30
214,9273,575,211,364,0500000US06051,6051,"Mono County, California",Mono County, California,62,13,13,0,637,344,339,5,0,0,0,0,3854,1065,709,356,619,42,0,42,394,143,70,73,654,129,129,0
215,122518,7198,3049,4149,0500000US06053,6053,"Monterey County, California",Monterey County, California,8264,1475,824,651,28474,3080,1203,1877,1995,135,115,20,248323,38281,17806,20475,24330,1850,783,1067,2881,330,178,152,149655,26644,12560,14084
216,70352,4093,1845,2248,0500000US06055,6055,"Napa County, California",Napa County, California,2512,431,192,239,9528,655,326,329,219,36,20,16,46549,4576,2014,2562,9936,569,254,315,936,136,32,104,15250,1993,867,1126
217,83501,7381,3447,3934,0500000US06057,6057,"Nevada County, California",Nevada County, California,331,36,23,13,4391,557,129,428,150,31,31,0,9285,1338,425,913,1093,55,38,17,496,53,53,0,1129,150,19,131
218,1249582,86327,38868,47459,0500000US06059,6059,"Orange County, California",Orange County, California,52506,6769,3271,3498,214405,17569,8279,9290,9297,916,460,456,1056947,142748,63746,79002,660655,72742,31998,40744,15321,1580,791,789,375668,60626,26015,34611
219,278342,17907,7919,9988,0500000US06061,6061,"Placer County, California",Placer County, California,6097,632,444,188,24651,1907,816,1091,898,19,0,19,55239,6202,2846,3356,31729,1555,775,780,2187,389,144,245,10309,1451,810,641
220,15325,1611,646,965,0500000US06063,6063,"Plumas County, California",Plumas County, California,242,97,97,0,914,244,135,109,29,0,0,0,1673,198,118,80,189,139,83,56,342,78,71,7,294,26,7,19
221,827142,76169,34759,41410,0500000US06065,6065,"Riverside County, California",Riverside County, California,153357,24902,11363,13539,187880,18930,8742,10188,7673,766,341,425,1185883,174510,77245,97265,160199,17555,8385,9170,18431,3852,1857,1995,531153,86835,37416,49419
222,665171,66823,30741,36082,0500000US06067,6067,"Sacramento County, California",Sacramento County, California,144013,29725,14872,14853,138777,20447,9527,10920,16878,2255,1047,1208,354534,61112,27901,33211,254658,37765,18638,19127,9289,2010,911,1099,123484,25934,11272,14662
223,20323,1132,456,676,0500000US06069,6069,"San Benito County, California",San Benito County, California,509,57,27,30,7311,833,325,508,63,0,0,0,36808,4414,1987,2427,1731,31,22,9,527,9,0,9,6206,683,384,299
224,578828,62533,29011,33522,0500000US06071,6071,"San Bernardino County, California",San Bernardino County, California,166608,37804,16526,21278,197023,29048,13578,15470,6537,1138,519,619,1139985,187185,83618,103567,157318,17161,7417,9744,17717,3228,1247,1981,378254,62414,28802,33612
225,1449546,116529,55315,61214,0500000US06073,6073,"San Diego County, California",San Diego County, California,153065,29420,13443,15977,282341,31443,14795,16648,13271,2075,1390,685,1102992,158675,70932,87743,393751,37664,16859,20805,23489,3272,1628,1644,216589,32255,13588,18667
226,343642,24283,13000,11283,0500000US06075,6075,"San Francisco County, California",San Francisco County, California,43597,11388,5332,6056,61577,5404,2752,2652,3178,413,84,329,129303,17332,8237,9095,296815,29320,12391,16929,3775,904,477,427,65516,10107,4726,5381
227,223754,21511,9451,12060,0500000US06077,6077,"San Joaquin County, California",San Joaquin County, California,50011,10255,4202,6053,105102,15783,7358,8425,4529,740,325,415,308572,50003,22615,27388,118007,14130,6325,7805,4516,670,336,334,75959,12275,5562,6713
228,184835,19249,8966,10283,0500000US06079,6079,"San Luis Obispo County, California",San Luis Obispo County, California,2761,644,406,238,17416,1847,1153,694,240,0,0,0,61330,6710,3318,3392,8560,1587,870,717,2197,160,59,101,11600,1710,952,758
229,293127,13477,5772,7705,0500000US06081,6081,"San Mateo County, California",San Mateo County, California,17489,1817,1085,732,57104,3121,1181,1940,9550,868,258,610,182330,17976,8057,9919,223825,11276,5037,6239,3869,965,475,490,80147,8349,3877,4472
230,188108,18532,8202,10330,0500000US06083,6083,"Santa Barbara County, California",Santa Barbara County, California,7618,1604,577,1027,41629,6215,2998,3217,465,129,79,50,196399,28978,12532,16446,20120,4030,2192,1838,4750,824,481,343,40398,6118,2545,3573
231,577752,29484,13906,15578,0500000US06085,6085,"Santa Clara County, California",Santa Clara County, California,45368,5348,2776,2572,140937,9048,3719,5329,6832,524,348,176,472853,47983,20075,27908,718709,47991,22067,25924,9743,1235,530,705,186381,23725,10419,13306
232,151085,14679,6665,8014,0500000US06087,6087,"Santa Cruz County, California",Santa Cruz County, California,2975,281,154,127,18133,1640,674,966,466,68,39,29,88267,13356,6181,7175,10707,1943,917,1026,1621,317,192,125,37701,6964,3207,3757
233,139500,19287,8979,10308,0500000US06089,6089,"Shasta County, California",Shasta County, California,1771,315,193,122,10132,1853,757,1096,261,20,3,17,18094,3618,1631,1987,5578,1372,533,839,4343,633,338,295,3722,816,268,548
234,2535,226,111,115,0500000US06091,6091,"Sierra County, California",Sierra County, California,1,1,0,1,16,0,0,0,0,0,0,0,293,27,6,21,0,0,0,0,69,17,13,4,88,0,0,0
235,32651,4832,2218,2614,0500000US06093,6093,"Siskiyou County, California",Siskiyou County, California,635,259,121,138,3383,782,338,444,156,41,25,16,5514,1269,577,692,537,123,78,45,1664,380,182,198,819,117,40,77
236,162445,11239,4825,6414,0500000US06095,6095,"Solano County, California",Solano County, California,57127,9013,3860,5153,40616,3542,1564,1978,4066,718,239,479,116416,12601,6034,6567,68557,3962,1742,2220,2340,315,173,142,38969,4454,2220,2234
237,307128,22564,9420,13144,0500000US06097,6097,"Sonoma County, California",Sonoma County, California,7953,1340,733,607,34531,2791,1472,1319,1502,208,92,116,131636,15473,6489,8984,20834,1666,692,974,4334,313,190,123,64964,9750,3657,6093
238,220458,24937,11325,13612,0500000US06099,6099,"Stanislaus County, California",Stanislaus County, California,16765,2591,1410,1181,47144,6508,3861,2647,3225,272,139,133,255189,38962,18168,20794,31789,4648,2160,2488,4574,634,179,455,56742,7282,2829,4453
239,43042,4836,2244,2592,0500000US06101,6101,"Sutter County, California",Sutter County, California,1851,161,86,75,9294,876,287,589,588,82,33,49,29702,5308,2335,2973,15934,1540,771,769,1047,200,120,80,5813,1034,443,591
240,42813,6528,3010,3518,0500000US06103,6103,"Tehama County, California",Tehama County, California,363,43,19,24,4323,935,650,285,15,0,0,0,16205,4143,2229,1914,1090,253,134,119,859,387,127,260,3249,889,500,389
241,9977,2301,1027,1274,0500000US06105,6105,"Trinity County, California",Trinity County, California,48,2,2,0,320,0,0,0,35,0,0,0,846,252,101,151,233,97,71,26,722,42,12,30,414,195,99,96
242,126608,15316,6199,9117,0500000US06107,6107,"Tulare County, California",Tulare County, California,7337,1814,1096,718,36455,5498,2406,3092,608,291,190,101,298426,78610,37304,41306,17107,2885,1663,1222,5863,1966,1023,943,84356,22313,10826,11487
243,41764,4079,1916,2163,0500000US06109,6109,"Tuolumne County, California",Tuolumne County, California,281,3,2,1,2489,367,171,196,108,6,2,4,5849,935,475,460,636,77,52,25,833,295,107,188,1193,1,0,1
244,375232,24997,10850,14147,0500000US06111,6111,"Ventura County, California",Ventura County, California,14452,1477,720,757,70573,5091,2206,2885,1931,57,43,14,355976,42622,19111,23511,60709,3721,1740,1981,6839,1552,629,923,49035,6574,3275,3299
245,97885,13102,5739,7363,0500000US06113,6113,"Yolo County, California",Yolo County, California,5362,1885,732,1153,20773,3221,1202,2019,1000,21,14,7,67346,12536,5410,7126,28772,9743,4310,5433,1412,343,133,210,11748,2516,1288,1228
246,41071,4660,1897,2763,0500000US06115,6115,"Yuba County, California",Yuba County, California,2390,216,110,106,7386,1478,609,869,295,26,18,8,21803,4359,2075,2284,5541,1622,1006,616,996,210,101,109,3209,360,148,212
247,247543,16520,7174,9346,0500000US08001,8001,"Adams County, Colorado",Adams County, Colorado,16665,2576,1257,1319,44927,6290,2882,3408,801,125,72,53,204157,26978,11711,15267,20233,2057,839,1218,5230,658,270,388,34046,4040,1722,2318
248,7252,786,345,441,0500000US08003,8003,"Alamosa County, Colorado",Alamosa County, Colorado,78,6,6,0,1110,159,114,45,65,0,0,0,7076,1920,959,961,181,115,68,47,556,60,23,37,1075,297,234,63
249,383093,20341,9003,11338,0500000US08005,8005,"Arapahoe County, Colorado",Arapahoe County, Colorado,70223,8717,4264,4453,41479,3850,1924,1926,1574,192,90,102,124999,14927,6615,8312,40342,4111,2093,2018,4421,422,190,232,37564,5496,2377,3119
250,10276,663,278,385,0500000US08007,8007,"Archuleta County, Colorado",Archuleta County, Colorado,165,49,16,33,313,103,81,22,18,0,0,0,2481,360,269,91,153,8,0,8,303,60,39,21,1434,184,138,46
251,2899,550,197,353,0500000US08009,8009,"Baca County, Colorado",Baca County, Colorado,33,0,0,0,101,50,19,31,2,2,2,0,400,4,4,0,0,0,0,0,60,23,23,0,74,0,0,0
252,2353,345,157,188,0500000US08011,8011,"Bent County, Colorado",Bent County, Colorado,33,0,0,0,309,77,45,32,0,0,0,0,1290,391,194,197,28,25,25,0,173,36,32,4,178,56,0,56
253,242493,25710,13102,12608,0500000US08013,8013,"Boulder County, Colorado",Boulder County, Colorado,2740,579,307,272,13764,1908,782,1126,197,26,0,26,43222,6017,2807,3210,14410,1563,848,715,1603,174,130,44,6795,1121,572,549
254,52813,2430,925,1505,0500000US08014,8014,"Broomfield County, Colorado",Broomfield County, Colorado,1000,42,42,0,3273,194,40,154,0,0,0,0,8711,731,327,404,4595,175,96,79,332,10,0,10,746,146,63,83
255,16371,1624,807,817,0500000US08015,8015,"Chaffee County, Colorado",Chaffee County, Colorado,92,0,0,0,389,33,31,2,102,0,0,0,1602,475,223,252,186,63,19,44,1,0,0,0,380,27,27,0
256,1637,187,97,90,0500000US08017,8017,"Cheyenne County, Colorado",Cheyenne County, Colorado,0,0,0,0,165,69,42,27,6,0,0,0,200,0,0,0,21,0,0,0,0,0,0,0,3,0,0,0
257,8283,533,199,334,0500000US08019,8019,"Clear Creek County, Colorado",Clear Creek County, Colorado,74,21,2,19,233,16,0,16,0,0,0,0,669,5,5,0,107,0,0,0,64,3,3,0,0,0,0,0
258,3615,428,234,194,0500000US08021,8021,"Conejos County, Colorado",Conejos County, Colorado,23,12,4,8,719,140,101,39,0,0,0,0,4225,1173,595,578,21,0,0,0,194,35,19,16,419,114,47,67
259,1280,425,260,165,0500000US08023,8023,"Costilla County, Colorado",Costilla County, Colorado,13,13,13,0,589,202,63,139,0,0,0,0,2338,493,255,238,43,0,0,0,78,22,16,6,163,73,38,35
260,2687,587,360,227,0500000US08025,8025,"Crowley County, Colorado",Crowley County, Colorado,28,0,0,0,639,107,22,85,0,0,0,0,1411,522,376,146,69,0,0,0,85,46,26,20,24,1,0,1
261,4227,375,204,171,0500000US08027,8027,"Custer County, Colorado",Custer County, Colorado,84,0,0,0,55,0,0,0,0,0,0,0,575,2,0,2,18,0,0,0,5,0,0,0,165,2,0,2
262,24193,3942,1524,2418,0500000US08029,8029,"Delta County, Colorado",Delta County, Colorado,227,41,8,33,700,35,23,12,0,0,0,0,4265,1190,562,628,262,108,21,87,169,51,51,0,396,67,30,37
263,381293,29338,14220,15118,0500000US08031,8031,"Denver County, Colorado",Denver County, Colorado,64249,14661,7040,7621,49794,7661,2913,4748,1157,74,34,40,208586,33265,14945,18320,25566,3675,1162,2513,5239,1000,429,571,49444,7581,2963,4618
264,1503,89,52,37,0500000US08033,8033,"Dolores County, Colorado",Dolores County, Colorado,0,0,0,0,26,26,0,26,0,0,0,0,268,15,0,15,0,0,0,0,92,0,0,0,69,0,0,0
265,279000,8390,3435,4955,0500000US08035,8035,"Douglas County, Colorado",Douglas County, Colorado,5037,606,279,327,13516,361,197,164,224,3,0,3,30351,1258,644,614,17518,386,136,250,1271,37,14,23,5152,328,250,78
266,36470,2072,993,1079,0500000US08037,8037,"Eagle County, Colorado",Eagle County, Colorado,541,48,48,0,3957,670,250,420,0,0,0,0,15931,2723,861,1862,303,112,49,63,130,97,12,85,2476,294,86,208
267,22760,1035,454,581,0500000US08039,8039,"Elbert County, Colorado",Elbert County, Colorado,55,2,0,2,1365,57,0,57,9,0,0,0,1923,157,69,88,262,5,0,5,282,33,0,33,254,3,3,0
268,474490,38565,18300,20265,0500000US08041,8041,"El Paso County, Colorado",El Paso County, Colorado,42578,5627,2647,2980,53471,7000,3188,3812,2321,343,171,172,120282,18888,8639,10249,18138,1383,787,596,5310,1058,436,622,27028,4457,1885,2572
269,32840,4008,1761,2247,0500000US08043,8043,"Fremont County, Colorado",Fremont County, Colorado,151,46,38,8,665,116,83,33,7,0,0,0,3130,740,277,463,216,34,3,31,106,12,8,4,324,92,2,90
270,39831,2544,1215,1329,0500000US08045,8045,"Garfield County, Colorado",Garfield County, Colorado,249,69,69,0,2780,126,65,61,55,0,0,0,16845,1704,715,989,471,0,0,0,274,91,57,34,5138,536,251,285
271,5176,294,138,156,0500000US08047,8047,"Gilpin County, Colorado",Gilpin County, Colorado,23,0,0,0,146,6,0,6,0,0,0,0,486,26,11,15,0,0,0,0,164,0,0,0,5,0,0,0
272,13292,917,415,502,0500000US08049,8049,"Grand County, Colorado",Grand County, Colorado,121,11,5,6,643,28,0,28,26,0,0,0,1403,360,207,153,104,89,68,21,138,0,0,0,79,14,14,0
273,14212,1706,892,814,0500000US08051,8051,"Gunnison County, Colorado",Gunnison County, Colorado,20,0,0,0,499,94,16,78,0,0,0,0,1548,188,19,169,65,10,0,10,200,36,36,0,151,0,0,0
274,675,59,23,36,0500000US08053,8053,"Hinsdale County, Colorado",Hinsdale County, Colorado,13,0,0,0,10,0,0,0,0,0,0,0,75,17,17,0,3,0,0,0,21,4,0,4,14,0,0,0
275,4037,601,257,344,0500000US08055,8055,"Huerfano County, Colorado",Huerfano County, Colorado,3,3,0,3,263,11,11,0,0,0,0,0,2238,447,151,296,2,2,0,2,191,30,28,2,122,25,25,0
276,1148,70,45,25,0500000US08057,8057,"Jackson County, Colorado",Jackson County, Colorado,8,0,0,0,11,1,1,0,0,0,0,0,144,48,19,29,0,0,0,0,0,0,0,0,0,0,0,0
277,443255,24206,11191,13015,0500000US08059,8059,"Jefferson County, Colorado",Jefferson County, Colorado,6009,789,501,288,27141,2925,1452,1473,412,27,26,1,87810,10664,5223,5441,16115,1254,457,797,3437,278,105,173,12228,1309,623,686
278,1350,169,49,120,0500000US08061,8061,"Kiowa County, Colorado",Kiowa County, Colorado,0,0,0,0,13,0,0,0,0,0,0,0,66,23,5,18,0,0,0,0,2,2,0,2,4,0,0,0
279,5501,402,166,236,0500000US08063,8063,"Kit Carson County, Colorado",Kit Carson County, Colorado,3,2,0,2,213,35,0,35,46,0,0,0,1298,57,32,25,10,0,0,0,40,24,14,10,419,6,6,0
280,5151,321,312,9,0500000US08065,8065,"Lake County, Colorado",Lake County, Colorado,1,1,1,0,729,296,21,275,0,0,0,0,2042,585,78,507,39,0,0,0,253,0,0,0,457,237,6,231
281,42642,3651,1616,2035,0500000US08067,8067,"La Plata County, Colorado",La Plata County, Colorado,216,27,18,9,1897,177,128,49,13,0,0,0,7089,1042,418,624,397,189,66,123,3093,948,419,529,1426,124,39,85
282,280567,29053,13685,15368,0500000US08069,8069,"Larimer County, Colorado",Larimer County, Colorado,3116,626,261,365,17038,2079,946,1133,266,46,24,22,39459,5367,2492,2875,7095,819,239,580,2390,496,252,244,6121,724,334,390
283,7116,1035,464,571,0500000US08071,8071,"Las Animas County, Colorado",Las Animas County, Colorado,55,0,0,0,1156,302,148,154,0,0,0,0,5706,1284,538,746,76,0,0,0,558,57,31,26,457,92,49,43
284,3175,381,149,232,0500000US08073,8073,"Lincoln County, Colorado",Lincoln County, Colorado,4,0,0,0,44,6,0,6,10,8,0,8,214,78,50,28,16,0,0,0,10,0,0,0,28,9,4,5
285,16426,1620,877,743,0500000US08075,8075,"Logan County, Colorado",Logan County, Colorado,184,109,108,1,973,310,211,99,338,0,0,0,3584,331,197,134,179,8,4,4,189,8,8,0,529,10,9,1
286,121121,12890,6309,6581,0500000US08077,8077,"Mesa County, Colorado",Mesa County, Colorado,1071,195,124,71,5534,920,388,532,124,50,0,50,21724,5103,2274,2829,1648,214,124,90,1451,596,141,455,2162,255,63,192
287,703,96,31,65,0500000US08079,8079,"Mineral County, Colorado",Mineral County, Colorado,11,11,0,11,67,0,0,0,0,0,0,0,34,21,12,9,47,0,0,0,13,12,12,0,11,8,0,8
288,10404,1564,748,816,0500000US08081,8081,"Moffat County, Colorado",Moffat County, Colorado,105,29,29,0,795,260,133,127,0,0,0,0,2048,619,352,267,18,0,0,0,88,25,0,25,101,28,0,28
289,18663,1869,945,924,0500000US08083,8083,"Montezuma County, Colorado",Montezuma County, Colorado,272,96,12,84,693,125,22,103,20,0,0,0,3319,736,407,329,222,7,7,0,3123,426,207,219,687,269,156,113
290,31726,3890,1636,2254,0500000US08085,8085,"Montrose County, Colorado",Montrose County, Colorado,80,13,13,0,2079,67,0,67,55,1,0,1,8636,1129,616,513,403,120,55,65,535,37,25,12,699,37,11,26
291,16347,1868,849,1019,0500000US08087,8087,"Morgan County, Colorado",Morgan County, Colorado,877,224,154,70,2249,289,25,264,69,0,0,0,10203,885,238,647,138,7,0,7,83,0,0,0,1258,27,19,8
292,9352,1442,705,737,0500000US08089,8089,"Otero County, Colorado",Otero County, Colorado,103,83,24,59,991,357,255,102,6,0,0,0,7598,2029,820,1209,212,170,69,101,209,138,101,37,961,120,41,79
293,4553,226,79,147,0500000US08091,8091,"Ouray County, Colorado",Ouray County, Colorado,76,31,10,21,140,55,11,44,3,0,0,0,133,14,14,0,0,0,0,0,20,0,0,0,11,0,0,0
294,15961,1246,709,537,0500000US08093,8093,"Park County, Colorado",Park County, Colorado,42,2,2,0,689,24,22,2,0,0,0,0,1113,3,3,0,119,0,0,0,156,0,0,0,191,0,0,0
295,2918,302,118,184,0500000US08095,8095,"Phillips County, Colorado",Phillips County, Colorado,0,0,0,0,118,12,7,5,0,0,0,0,1325,34,18,16,18,0,0,0,84,0,0,0,67,0,0,0
296,15160,846,462,384,0500000US08097,8097,"Pitkin County, Colorado",Pitkin County, Colorado,80,13,0,13,568,123,10,113,0,0,0,0,1819,13,0,13,412,34,0,34,15,0,0,0,628,0,0,0
297,6813,951,423,528,0500000US08099,8099,"Prowers County, Colorado",Prowers County, Colorado,45,45,0,45,437,114,69,45,0,0,0,0,4577,842,380,462,47,8,4,4,236,26,0,26,286,20,4,16
298,83997,11795,5470,6325,0500000US08101,8101,"Pueblo County, Colorado",Pueblo County, Colorado,3073,957,380,577,9452,1859,1000,859,222,39,0,39,71231,15069,6641,8428,1482,106,30,76,5149,1596,497,1099,13446,3144,1597,1547
299,5067,486,253,233,0500000US08103,8103,"Rio Blanco County, Colorado",Rio Blanco County, Colorado,9,0,0,0,355,107,37,70,0,0,0,0,614,31,11,20,29,0,0,0,83,42,9,33,32,0,0,0
300,5734,724,300,424,0500000US08105,8105,"Rio Grande County, Colorado",Rio Grande County, Colorado,8,6,6,0,492,35,13,22,5,0,0,0,4934,891,384,507,0,0,0,0,320,117,45,72,382,62,50,12
301,22124,1807,785,1022,0500000US08107,8107,"Routt County, Colorado",Routt County, Colorado,225,26,17,9,691,209,23,186,4,0,0,0,1723,310,150,160,342,35,9,26,70,0,0,0,267,59,50,9
302,3959,412,175,237,0500000US08109,8109,"Saguache County, Colorado",Saguache County, Colorado,74,74,74,0,343,170,28,142,0,0,0,0,2404,421,150,271,7,5,5,0,91,30,28,2,250,40,26,14
303,484,20,5,15,0500000US08111,8111,"San Juan County, Colorado",San Juan County, Colorado,0,0,0,0,37,30,18,12,0,0,0,0,155,85,33,52,0,0,0,0,0,0,0,0,0,0,0,0
304,6913,482,194,288,0500000US08113,8113,"San Miguel County, Colorado",San Miguel County, Colorado,0,0,0,0,198,58,44,14,0,0,0,0,879,251,86,165,112,91,0,91,77,0,0,0,66,52,2,50
305,1786,361,144,217,0500000US08115,8115,"Sedgwick County, Colorado",Sedgwick County, Colorado,7,0,0,0,119,8,8,0,0,0,0,0,441,93,16,77,7,0,0,0,9,0,0,0,94,16,6,10
306,24705,1198,469,729,0500000US08117,8117,"Summit County, Colorado",Summit County, Colorado,56,43,24,19,1121,101,0,101,108,80,39,41,4388,867,276,591,277,10,0,10,93,2,2,0,1609,234,0,234
307,21468,2055,769,1286,0500000US08119,8119,"Teller County, Colorado",Teller County, Colorado,162,17,17,0,1377,10,0,10,10,0,0,0,1716,205,134,71,49,0,0,0,215,0,0,0,92,32,32,0
308,4050,413,214,199,0500000US08121,8121,"Washington County, Colorado",Washington County, Colorado,29,2,2,0,101,43,40,3,1,0,0,0,394,101,21,80,19,1,0,1,0,0,0,0,27,2,0,2
309,200767,14984,6346,8638,0500000US08123,8123,"Weld County, Colorado",Weld County, Colorado,3452,1087,565,522,16575,2472,1060,1412,350,8,5,3,91392,13751,6068,7683,5217,794,443,351,1657,184,94,90,11900,1282,692,590
310,7277,627,346,281,0500000US08125,8125,"Yuma County, Colorado",Yuma County, Colorado,137,0,0,0,416,39,27,12,0,0,0,0,2165,460,222,238,0,0,0,0,69,12,12,0,212,84,41,43
311,565526,26227,10891,15336,0500000US09001,9001,"Fairfield County, Connecticut",Fairfield County, Connecticut,104319,16279,6562,9717,47839,4811,2099,2712,554,78,25,53,186371,34973,15137,19836,50507,4182,1898,2284,1995,399,106,293,65097,16316,7485,8831
312,524535,30536,12623,17913,0500000US09003,9003,"Hartford County, Connecticut",Hartford County, Connecticut,117988,19168,9085,10083,47750,7277,3100,4177,322,10,10,0,160596,39780,17137,22643,49168,3655,1907,1748,2453,392,120,272,52631,14701,6576,8125
313,156827,9894,4489,5405,0500000US09005,9005,"Litchfield County, Connecticut",Litchfield County, Connecticut,2953,517,248,269,5351,398,238,160,0,0,0,0,11857,2021,1126,895,3494,370,267,103,297,59,59,0,2628,463,226,237
314,131695,7167,2901,4266,0500000US09007,9007,"Middlesex County, Connecticut",Middlesex County, Connecticut,8463,1369,639,730,5005,514,346,168,9,9,0,9,10015,1856,811,1045,4582,412,130,282,432,249,107,142,1476,444,252,192
315,513612,33909,14487,19422,0500000US09009,9009,"New Haven County, Connecticut",New Haven County, Connecticut,112183,22392,10020,12372,38136,5420,2329,3091,153,22,22,0,155286,31951,13269,18682,33177,3217,1571,1646,1450,336,209,127,49283,10801,4612,6189
316,192283,11897,5115,6782,0500000US09011,9011,"New London County, Connecticut",New London County, Connecticut,14013,2980,1613,1367,15337,1878,835,1043,43,5,0,5,27656,4917,2347,2570,10607,708,353,355,1525,94,27,67,8762,2424,1205,1219
317,115338,7279,3422,3857,0500000US09013,9013,"Tolland County, Connecticut",Tolland County, Connecticut,3406,736,460,276,4011,337,195,142,5,0,0,0,7732,1301,525,776,5639,1024,528,496,104,26,0,26,2762,852,239,613
318,92194,8118,3496,4622,0500000US09015,9015,"Windham County, Connecticut",Windham County, Connecticut,2210,618,322,296,4943,556,233,323,15,15,0,15,13442,3622,1436,2186,1449,349,124,225,454,86,21,65,3192,894,346,548
319,106910,10438,4550,5888,0500000US10001,10001,"Kent County, Delaware",Kent County, Delaware,42362,8017,3483,4534,9291,2230,754,1476,27,15,15,0,12695,2231,828,1403,3745,458,91,367,1151,200,100,100,2156,335,103,232
320,304761,22003,9061,12942,0500000US10003,10003,"New Castle County, Delaware",New Castle County, Delaware,135666,22714,9871,12843,19615,1916,884,1032,231,48,8,40,55659,9079,4445,4634,31499,3412,1422,1990,1457,131,69,62,14122,3321,1595,1726
321,169824,14089,5740,8349,0500000US10005,10005,"Sussex County, Delaware",Sussex County, Delaware,25126,5075,2081,2994,7947,1961,1141,820,431,0,0,0,20730,5103,2092,3011,2854,457,98,359,898,214,63,151,5212,917,368,549
322,243060,13568,5956,7612,0500000US11001,11001,"District of Columbia, District of Columbia",District of Columbia, District of Columbia,307255,74491,32359,42132,28280,3242,1690,1552,304,12,9,3,74502,9003,3941,5062,26284,3593,1546,2047,2310,788,442,346,33023,4952,2139,2813
323,153692,25618,11877,13741,0500000US12001,12001,"Alachua County, Florida",Alachua County, Florida,51888,14903,6658,8245,12158,3061,1181,1880,142,54,18,36,25225,6889,2818,4071,15377,3377,1940,1437,867,222,154,68,3622,833,497,336
324,21272,2421,1031,1390,0500000US12003,12003,"Baker County, Florida",Baker County, Florida,2866,162,0,162,1073,28,22,6,0,0,0,0,510,68,37,31,44,9,9,0,59,59,42,17,72,21,21,0
325,134963,14408,5741,8667,0500000US12005,12005,"Bay County, Florida",Bay County, Florida,18732,4477,2122,2355,8142,1752,678,1074,258,24,5,19,11680,1909,838,1071,4071,458,169,289,539,8,0,8,2758,722,372,350
326,18643,3172,1338,1834,0500000US12007,12007,"Bradford County, Florida",Bradford County, Florida,3597,1221,606,615,314,26,11,15,0,0,0,0,836,280,194,86,183,32,32,0,34,13,13,0,75,0,0,0
327,433817,40403,18028,22375,0500000US12009,12009,"Brevard County, Florida",Brevard County, Florida,57794,10068,4334,5734,27211,4579,1986,2593,553,0,0,0,62502,10875,5286,5589,13989,1467,547,920,1612,299,143,156,10804,2739,1463,1276
328,683545,64171,30685,33486,0500000US12011,12011,"Broward County, Florida",Broward County, Florida,549893,91870,39481,52389,137342,15105,6609,8496,1220,92,61,31,582494,75579,33317,42262,70187,7542,3581,3961,5046,734,311,423,66987,10366,4382,5984
329,10323,1482,496,986,0500000US12013,12013,"Calhoun County, Florida",Calhoun County, Florida,1095,148,11,137,394,213,158,55,0,0,0,0,455,226,200,26,14,0,0,0,203,62,37,25,143,66,66,0
330,152945,14103,7065,7038,0500000US12015,12015,"Charlotte County, Florida",Charlotte County, Florida,9378,1811,656,1155,5143,535,284,251,144,21,0,21,13572,2739,1344,1395,2402,92,28,64,435,125,38,87,1929,222,91,131
331,127550,18577,8266,10311,0500000US12017,12017,"Citrus County, Florida",Citrus County, Florida,3468,748,442,306,3851,434,209,225,18,18,0,18,8382,1431,697,734,2582,432,101,331,400,80,56,24,1164,377,195,182
332,153659,13912,6562,7350,0500000US12019,12019,"Clay County, Florida",Clay County, Florida,23526,2681,1419,1262,13369,1204,495,709,82,0,0,0,21765,2303,1162,1141,5934,502,143,359,236,30,24,6,5550,581,172,409
333,235385,17739,8265,9474,0500000US12021,12021,"Collier County, Florida",Collier County, Florida,25131,3701,1907,1794,19468,2438,1479,959,36,0,0,0,105757,19059,9114,9945,5638,231,117,114,748,164,53,111,7060,1865,829,1036
334,49077,5533,2703,2830,0500000US12023,12023,"Columbia County, Florida",Columbia County, Florida,10538,2507,1079,1428,2346,502,325,177,0,0,0,0,3778,668,267,401,667,169,112,57,89,53,0,53,736,217,85,132
335,19881,3365,1837,1528,0500000US12027,12027,"DeSoto County, Florida",DeSoto County, Florida,3518,1286,678,608,1049,384,314,70,30,30,25,5,11429,4324,2421,1903,161,87,57,30,25,0,0,0,852,485,458,27
336,13439,1927,861,1066,0500000US12029,12029,"Dixie County, Florida",Dixie County, Florida,610,283,240,43,445,37,15,22,6,6,0,6,601,287,171,116,36,0,0,0,1,1,0,1,272,230,143,87
337,479322,48426,20710,27716,0500000US12031,12031,"Duval County, Florida",Duval County, Florida,274198,60733,25253,35480,47213,7301,3271,4030,611,87,56,31,94492,15867,6822,9045,43899,5089,2425,2664,2110,323,109,214,23378,3554,1754,1800
338,192327,20067,9172,10895,0500000US12033,12033,"Escambia County, Florida",Escambia County, Florida,65961,15116,6868,8248,17513,3584,1517,2067,461,150,59,91,15820,2710,1215,1495,9239,722,316,406,977,124,30,94,3187,736,333,403
339,82961,8348,3629,4719,0500000US12035,12035,"Flagler County, Florida",Flagler County, Florida,10935,1448,820,628,3717,773,515,258,140,0,0,0,11784,1789,621,1168,2878,192,102,90,258,27,27,0,4179,918,292,626
340,8637,1575,795,780,0500000US12037,12037,"Franklin County, Florida",Franklin County, Florida,772,225,82,143,346,82,22,60,0,0,0,0,407,111,43,68,34,0,0,0,0,0,0,0,221,186,73,113
341,13083,1298,788,510,0500000US12039,12039,"Gadsden County, Florida",Gadsden County, Florida,24013,6027,2387,3640,837,161,80,81,21,0,0,0,4502,1633,896,737,63,0,0,0,129,76,40,36,1179,728,521,207
342,15217,1693,814,879,0500000US12041,12041,"Gilchrist County, Florida",Gilchrist County, Florida,383,209,83,126,427,80,33,47,2,2,2,0,849,202,93,109,31,4,0,4,10,3,2,1,80,16,11,5
343,7778,880,300,580,0500000US12043,12043,"Glades County, Florida",Glades County, Florida,1462,439,256,183,126,79,10,69,0,0,0,0,2501,644,271,373,91,0,0,0,533,113,75,38,291,26,3,23
344,10853,1093,420,673,0500000US12045,12045,"Gulf County, Florida",Gulf County, Florida,1007,232,91,141,213,90,60,30,0,0,0,0,194,106,54,52,84,11,0,11,19,0,0,0,17,17,0,17
345,6634,1434,615,819,0500000US12047,12047,"Hamilton County, Florida",Hamilton County, Florida,3153,919,466,453,114,29,29,0,0,0,0,0,1102,446,200,246,97,68,32,36,146,112,74,38,139,73,25,48
346,11839,2040,711,1329,0500000US12049,12049,"Hardee County, Florida",Hardee County, Florida,1138,241,153,88,1629,365,128,237,6,0,0,0,11300,3785,1459,2326,310,1,1,0,46,0,0,0,2383,753,339,414
347,12662,2272,930,1342,0500000US12051,12051,"Hendry County, Florida",Hendry County, Florida,4563,951,472,479,3472,1116,270,846,0,0,0,0,22422,7628,4220,3408,364,115,48,67,797,338,238,100,1487,525,286,239
348,144432,18174,8253,9921,0500000US12053,12053,"Hernando County, Florida",Hernando County, Florida,9722,2024,924,1100,8290,1259,621,638,111,0,0,0,26655,5480,2682,2798,2276,185,45,140,519,157,62,95,4020,1143,472,671
349,68089,8009,3667,4342,0500000US12055,12055,"Highlands County, Florida",Highlands County, Florida,9770,2580,1122,1458,3713,749,316,433,0,0,0,0,20866,5138,2472,2666,1545,291,133,158,136,20,0,20,6029,1397,525,872
350,683944,63564,29118,34446,0500000US12057,12057,"Hillsborough County, Florida",Hillsborough County, Florida,238186,49707,20300,29407,106622,16840,8473,8367,1078,57,20,37,418210,76668,35770,40898,60086,7419,3631,3788,3905,547,242,305,60803,12866,6134,6732
351,16081,3298,1511,1787,0500000US12059,12059,"Holmes County, Florida",Holmes County, Florida,594,322,134,188,387,83,70,13,63,22,22,0,337,67,51,16,135,0,0,0,203,16,11,5,58,34,15,19
352,116789,8940,4265,4675,0500000US12061,12061,"Indian River County, Florida",Indian River County, Florida,12742,3893,1947,1946,6126,459,299,160,120,0,0,0,19506,2237,994,1243,2227,457,336,121,408,20,20,0,2666,311,140,171
353,27969,4420,1962,2458,0500000US12063,12063,"Jackson County, Florida",Jackson County, Florida,9149,2296,994,1302,949,103,80,23,23,0,0,0,1157,362,135,227,213,0,0,0,280,0,0,0,175,21,4,17
354,7983,568,271,297,0500000US12065,12065,"Jefferson County, Florida",Jefferson County, Florida,3791,1334,675,659,217,40,0,40,0,0,0,0,310,75,22,53,51,46,10,36,24,0,0,0,61,45,0,45
355,5090,941,355,586,0500000US12067,12067,"Lafayette County, Florida",Lafayette County, Florida,769,239,92,147,96,0,0,0,95,22,22,0,1108,67,28,39,0,0,0,0,0,0,0,0,0,0,0,0
356,242710,22056,9318,12738,0500000US12069,12069,"Lake County, Florida",Lake County, Florida,36660,6692,2529,4163,17159,1442,566,876,511,120,33,87,56953,8803,3879,4924,7435,519,258,261,1397,79,41,38,6431,1482,807,675
357,495348,42937,19077,23860,0500000US12071,12071,"Lee County, Florida",Lee County, Florida,61218,13019,5857,7162,37248,4303,1592,2711,433,50,42,8,163985,30180,13927,16253,12451,1001,286,715,1269,134,7,127,27024,4828,2265,2563
358,156155,22232,11064,11168,0500000US12073,12073,"Leon County, Florida",Leon County, Florida,87066,25339,11815,13524,10034,1751,851,900,113,35,35,0,17369,3933,1774,2159,10352,1581,771,810,338,111,93,18,3277,875,301,574
359,32104,5538,2251,3287,0500000US12075,12075,"Levy County, Florida",Levy County, Florida,3314,926,358,568,1731,216,88,128,0,0,0,0,3504,921,513,408,387,50,38,12,67,36,36,0,285,204,200,4
360,5740,998,396,602,0500000US12077,12077,"Liberty County, Florida",Liberty County, Florida,486,186,113,73,351,97,80,17,0,0,0,0,132,49,25,24,35,0,0,0,98,88,88,0,42,7,7,0
361,8964,1556,795,761,0500000US12079,12079,"Madison County, Florida",Madison County, Florida,6099,2758,1151,1607,408,75,37,38,4,0,0,0,796,428,330,98,118,0,0,0,21,13,0,13,315,257,179,78
362,276491,21251,8860,12391,0500000US12081,12081,"Manatee County, Florida",Manatee County, Florida,32606,6405,2715,3690,14599,2356,1270,1086,299,0,0,0,63898,12219,6533,5686,8262,1588,718,870,785,27,12,15,8566,1541,759,782
363,244778,30383,12459,17924,0500000US12083,12083,"Marion County, Florida",Marion County, Florida,43581,11899,5069,6830,14716,2399,1123,1276,86,37,37,0,47895,10115,4781,5334,5059,575,267,308,904,140,127,13,4576,1365,715,650
364,123237,9870,4823,5047,0500000US12085,12085,"Martin County, Florida",Martin County, Florida,8012,1878,941,937,4659,901,244,657,192,0,0,0,21647,4372,1658,2714,2381,126,53,73,835,57,1,56,3764,1019,392,627
365,355982,34366,16750,17616,0500000US12086,12086,"Miami-Dade County, Florida",Miami-Dade County, Florida,445117,105044,48368,56676,286777,38665,17630,21035,861,194,134,60,1829068,284057,119835,164222,42444,7226,3101,4125,5217,590,287,303,125051,19901,9009,10892
366,48433,3794,1809,1985,0500000US12087,12087,"Monroe County, Florida",Monroe County, Florida,5456,1287,738,549,3053,320,65,255,124,84,13,71,18161,2446,1250,1196,953,81,47,34,68,32,0,32,1609,493,244,249
367,73433,6383,2888,3495,0500000US12089,12089,"Nassau County, Florida",Nassau County, Florida,4721,1084,356,728,1713,459,230,229,0,0,0,0,3833,388,238,150,829,87,87,0,487,0,0,0,1248,242,167,75
368,147709,13344,6573,6771,0500000US12091,12091,"Okaloosa County, Florida",Okaloosa County, Florida,18455,2753,1059,1694,12077,2183,1122,1061,517,0,0,0,18951,3217,1510,1707,6594,821,359,462,517,41,19,22,6937,1395,547,848
369,25165,3213,1503,1710,0500000US12093,12093,"Okeechobee County, Florida",Okeechobee County, Florida,2082,622,132,490,1232,224,168,56,83,0,0,0,9662,2628,1400,1228,393,0,0,0,223,138,0,138,1561,258,119,139
370,518703,47238,21922,25316,0500000US12095,12095,"Orange County, Florida",Orange County, Florida,282175,53049,25125,27924,101215,12236,5531,6705,969,76,52,24,435197,77717,34866,42851,71648,9203,4137,5066,2671,697,389,308,83782,16013,7195,8818
371,111051,10023,4569,5454,0500000US12097,12097,"Osceola County, Florida",Osceola County, Florida,39098,6023,2309,3714,32244,4189,2235,1954,91,70,25,45,197980,31172,14519,16653,10054,1384,664,720,1264,154,81,73,38439,5473,2746,2727
372,789225,58530,24289,34241,0500000US12099,12099,"Palm Beach County, Florida",Palm Beach County, Florida,269806,49958,22845,27113,82350,11528,4180,7348,454,56,44,12,330778,53518,22346,31172,40734,3747,1750,1997,2845,125,102,23,41833,9861,3778,6083
373,389552,45362,20133,25229,0500000US12101,12101,"Pasco County, Florida",Pasco County, Florida,30080,3508,1700,1808,27232,3055,1243,1812,307,27,0,27,84721,13627,6066,7561,14488,1001,378,623,1531,91,41,50,9728,1617,767,850
374,703229,66865,29606,37259,0500000US12103,12103,"Pinellas County, Florida",Pinellas County, Florida,97062,21165,9800,11365,40780,6650,2910,3740,900,81,22,59,94663,14076,6150,7926,33249,3931,1652,2279,2436,539,248,291,15578,2084,1010,1074
375,398147,44955,19478,25477,0500000US12105,12105,"Polk County, Florida",Polk County, Florida,104200,24450,10905,13545,35172,5305,2628,2677,333,175,82,93,164010,31589,15063,16526,12169,1010,473,537,2253,627,300,327,29593,5417,2564,2853
376,51570,9607,4252,5355,0500000US12107,12107,"Putnam County, Florida",Putnam County, Florida,11547,4008,1765,2243,2557,954,344,610,16,16,16,0,7431,2411,946,1465,445,44,3,41,275,23,23,0,533,107,60,47
377,206829,13266,5608,7658,0500000US12109,12109,"St. Johns County, Florida",St. Johns County, Florida,13651,2432,1212,1220,9593,658,391,267,197,34,0,34,18424,2331,1321,1010,6991,554,288,266,722,78,20,58,2190,1107,867,240
378,179529,18573,7802,10771,0500000US12111,12111,"St. Lucie County, Florida",St. Lucie County, Florida,64200,10979,4621,6358,13839,2353,1015,1338,245,151,102,49,61661,10254,4536,5718,6403,634,236,398,1220,164,94,70,8011,1680,955,725
379,143792,12991,5657,7334,0500000US12113,12113,"Santa Rosa County, Florida",Santa Rosa County, Florida,7969,1108,571,537,8517,1271,510,761,518,215,49,166,9584,980,456,524,3341,257,46,211,827,194,123,71,2777,581,270,311
380,348777,25455,11271,14184,0500000US12115,12115,"Sarasota County, Florida",Sarasota County, Florida,18624,4086,1557,2529,11840,868,349,519,72,27,11,16,39702,5233,2071,3162,7652,1265,623,642,691,56,8,48,4121,261,122,139
381,273891,20313,8914,11399,0500000US12117,12117,"Seminole County, Florida",Seminole County, Florida,54925,9049,3642,5407,26416,3048,1511,1537,209,11,11,0,101687,12752,5912,6840,22054,1963,1015,948,1097,435,316,119,21635,3482,1635,1847
382,107466,7982,3335,4647,0500000US12119,12119,"Sumter County, Florida",Sumter County, Florida,5155,1905,412,1493,1989,60,11,49,80,8,0,8,5177,544,199,345,1123,0,0,0,221,18,18,0,835,219,116,103
383,32068,3090,1123,1967,0500000US12121,12121,"Suwannee County, Florida",Suwannee County, Florida,5449,1786,779,1007,1593,230,134,96,0,0,0,0,4097,937,555,382,140,0,0,0,58,58,53,5,872,22,22,0
384,14179,2309,1125,1184,0500000US12123,12123,"Taylor County, Florida",Taylor County, Florida,2990,1051,475,576,174,22,22,0,43,0,0,0,172,63,30,33,100,0,0,0,34,34,4,30,285,256,97,159
385,7883,1218,479,739,0500000US12125,12125,"Union County, Florida",Union County, Florida,737,204,84,120,489,45,26,19,0,0,0,0,313,78,10,68,68,0,0,0,8,0,0,0,29,4,0,4
386,381339,41845,18916,22929,0500000US12127,12127,"Volusia County, Florida",Volusia County, Florida,55743,12465,5620,6845,17307,2589,1146,1443,53,8,0,8,77869,13279,5987,7292,9858,1778,1025,753,1794,66,2,64,23310,4032,1757,2275
387,24592,1900,864,1036,0500000US12129,12129,"Wakulla County, Florida",Wakulla County, Florida,2998,109,84,25,855,153,34,119,0,0,0,0,733,11,4,7,151,0,0,0,142,20,20,0,100,4,4,0
388,58606,5928,2603,3325,0500000US12131,12131,"Walton County, Florida",Walton County, Florida,2748,453,359,94,2915,542,295,247,0,0,0,0,4260,1059,739,320,510,39,16,23,448,31,11,20,2354,730,497,233
389,17979,4041,1943,2098,0500000US12133,12133,"Washington County, Florida",Washington County, Florida,2636,940,514,426,510,88,40,48,98,34,0,34,724,96,16,80,169,45,4,41,296,83,43,40,151,0,0,0
390,12485,2522,1336,1186,0500000US13001,13001,"Appling County, Georgia",Appling County, Georgia,3436,1013,500,513,377,72,0,72,0,0,0,0,1819,607,399,208,0,0,0,0,123,2,0,2,669,228,174,54
391,4609,662,262,400,0500000US13003,13003,"Atkinson County, Georgia",Atkinson County, Georgia,1289,594,297,297,384,316,158,158,0,0,0,0,2157,859,488,371,0,0,0,0,56,56,38,18,707,198,117,81
392,7797,1677,860,817,0500000US13005,13005,"Bacon County, Georgia",Bacon County, Georgia,1410,594,143,451,179,59,23,36,0,0,0,0,915,385,211,174,52,0,0,0,0,0,0,0,206,0,0,0
393,1549,277,157,120,0500000US13007,13007,"Baker County, Georgia",Baker County, Georgia,1181,283,149,134,32,32,32,0,17,0,0,0,141,8,0,8,175,42,3,39,3,3,3,0,0,0,0,0
394,21051,4227,1862,2365,0500000US13009,13009,"Baldwin County, Georgia",Baldwin County, Georgia,17473,4884,2283,2601,706,374,85,289,72,0,0,0,902,309,185,124,772,22,0,22,28,0,0,0,199,111,70,41
395,16544,2201,1047,1154,0500000US13011,13011,"Banks County, Georgia",Banks County, Georgia,408,39,19,20,487,163,132,31,0,0,0,0,1325,62,34,28,211,1,1,0,94,94,0,94,479,8,0,8
396,56357,5158,2227,2931,0500000US13013,13013,"Barrow County, Georgia",Barrow County, Georgia,9708,1961,874,1087,3866,565,243,322,5,0,0,0,9330,1375,627,748,3249,299,162,137,194,0,0,0,2456,372,164,208
397,79926,8799,4255,4544,0500000US13015,13015,"Bartow County, Georgia",Bartow County, Georgia,10246,1794,784,1010,4347,486,372,114,62,2,2,0,9389,2009,1104,905,983,99,38,61,154,48,40,8,3218,395,203,192
398,9144,1772,689,1083,0500000US13017,13017,"Ben Hill County, Georgia",Ben Hill County, Georgia,6056,2677,1267,1410,209,22,12,10,0,0,0,0,1049,349,195,154,99,0,0,0,0,0,0,0,482,270,163,107
399,15490,3295,1381,1914,0500000US13019,13019,"Berrien County, Georgia",Berrien County, Georgia,1886,476,260,216,563,345,204,141,0,0,0,0,1008,186,107,79,186,0,0,0,12,0,0,0,405,114,73,41
400,54841,7102,3372,3730,0500000US13021,13021,"Bibb County, Georgia",Bibb County, Georgia,80165,26757,10593,16164,4579,1396,712,684,57,0,0,0,4847,1448,740,708,2819,216,105,111,280,78,2,76,1438,663,248,415
401,8279,1056,409,647,0500000US13023,13023,"Bleckley County, Georgia",Bleckley County, Georgia,2890,1069,404,665,32,0,0,0,0,0,0,0,356,0,0,0,9,0,0,0,0,0,0,0,44,0,0,0
402,17294,3126,1378,1748,0500000US13025,13025,"Brantley County, Georgia",Brantley County, Georgia,649,196,145,51,288,20,8,12,0,0,0,0,432,24,16,8,174,174,134,40,43,0,0,0,88,0,0,0
403,8564,1081,482,599,0500000US13027,13027,"Brooks County, Georgia",Brooks County, Georgia,5546,2070,902,1168,283,39,29,10,17,17,17,0,909,431,158,273,96,0,0,0,0,0,0,0,517,256,90,166
404,27463,2367,1003,1364,0500000US13029,13029,"Bryan County, Georgia",Bryan County, Georgia,5498,1062,438,624,2022,119,64,55,26,0,0,0,2869,444,146,298,515,47,12,35,172,39,0,39,1165,83,33,50
405,44374,7936,4119,3817,0500000US13031,13031,"Bulloch County, Georgia",Bulloch County, Georgia,18804,5750,2607,3143,2736,683,357,326,208,208,103,105,2741,852,437,415,1018,255,210,45,153,94,47,47,1153,307,114,193
406,10363,940,343,597,0500000US13033,13033,"Burke County, Georgia",Burke County, Georgia,10573,3051,1212,1839,380,152,104,48,0,0,0,0,727,53,41,12,102,0,0,0,0,0,0,0,260,13,13,0
407,14871,2431,850,1581,0500000US13035,13035,"Butts County, Georgia",Butts County, Georgia,5511,2223,913,1310,592,16,16,0,0,0,0,0,602,13,0,13,117,0,0,0,2,0,0,0,185,0,0,0
408,1544,144,58,86,0500000US13037,13037,"Calhoun County, Georgia",Calhoun County, Georgia,2622,928,302,626,32,0,0,0,0,0,0,0,158,2,2,0,54,22,12,10,0,0,0,0,133,0,0,0
409,35906,3448,1595,1853,0500000US13039,13039,"Camden County, Georgia",Camden County, Georgia,9604,3299,1514,1785,2818,667,246,421,48,0,0,0,3640,370,197,173,1034,69,41,28,385,56,20,36,732,87,36,51
410,6361,954,356,598,0500000US13043,13043,"Candler County, Georgia",Candler County, Georgia,2620,905,413,492,296,206,96,110,0,0,0,0,1261,617,260,357,63,0,0,0,0,0,0,0,402,157,100,57
411,80943,10130,4869,5261,0500000US13045,13045,"Carroll County, Georgia",Carroll County, Georgia,21462,4917,1764,3153,3346,763,503,260,65,0,0,0,8080,2525,1256,1269,851,316,168,148,947,374,182,192,2762,834,381,453
412,60321,5284,2060,3224,0500000US13047,13047,"Catoosa County, Georgia",Catoosa County, Georgia,1343,264,151,113,1751,115,92,23,36,0,0,0,2038,101,0,101,913,148,59,89,231,57,0,57,1119,19,0,19
413,7820,1284,578,706,0500000US13049,13049,"Charlton County, Georgia",Charlton County, Georgia,3231,1086,459,627,372,158,73,85,0,0,0,0,160,133,84,49,128,95,69,26,149,0,0,0,54,36,0,36
414,132999,11165,4679,6486,0500000US13051,13051,"Chatham County, Georgia",Chatham County, Georgia,111131,22800,9231,13569,9089,1348,524,824,432,0,0,0,17962,3124,1401,1723,7668,1579,1004,575,673,95,25,70,5369,787,464,323
415,4113,491,232,259,0500000US13053,13053,"Chattahoochee County, Georgia",Chattahoochee County, Georgia,1295,429,115,314,509,82,79,3,40,0,0,0,976,186,65,121,242,90,30,60,15,0,0,0,245,40,20,20
416,19810,3748,1741,2007,0500000US13055,13055,"Chattooga County, Georgia",Chattooga County, Georgia,1162,252,128,124,632,277,216,61,0,0,0,0,1263,660,298,362,89,16,0,16,15,0,0,0,530,345,95,250
417,197299,9902,3782,6120,0500000US13057,13057,"Cherokee County, Georgia",Cherokee County, Georgia,16996,1734,741,993,9583,652,175,477,224,0,0,0,26590,5375,2758,2617,4721,184,113,71,724,141,105,36,4532,1576,792,784
418,62464,16046,7915,8131,0500000US13059,13059,"Clarke County, Georgia",Clarke County, Georgia,34050,10134,4027,6107,3611,666,310,356,53,12,12,0,12953,2884,1343,1541,3861,1098,481,617,211,10,1,9,2932,647,322,325
419,1219,198,80,118,0500000US13061,13061,"Clay County, Georgia",Clay County, Georgia,1601,743,248,495,6,0,0,0,0,0,0,0,10,0,0,0,31,0,0,0,0,0,0,0,11,0,0,0
420,26483,4875,2097,2778,0500000US13063,13063,"Clayton County, Georgia",Clayton County, Georgia,196260,33716,13369,20347,10559,2041,710,1331,201,103,103,0,37211,6185,2409,3776,14472,933,283,650,378,76,29,47,17161,2237,889,1348
421,4253,1005,486,519,0500000US13065,13065,"Clinch County, Georgia",Clinch County, Georgia,1652,733,378,355,95,35,12,23,0,0,0,0,402,27,15,12,2,0,0,0,156,152,152,0,238,15,15,0
422,380307,23124,10481,12643,0500000US13067,13067,"Cobb County, Georgia",Cobb County, Georgia,204458,20473,9013,11460,34829,3442,1784,1658,449,28,19,9,97336,17612,8740,8872,41341,1736,777,959,1685,340,164,176,36174,8504,4168,4336
423,23663,3911,1622,2289,0500000US13069,13069,"Coffee County, Georgia",Coffee County, Georgia,10269,2427,1044,1383,1372,362,220,142,0,0,0,0,4825,1528,654,874,287,17,0,17,18,0,0,0,622,136,105,31
424,24951,3577,1449,2128,0500000US13071,13071,"Colquitt County, Georgia",Colquitt County, Georgia,10324,3672,1485,2187,999,172,43,129,9,0,0,0,8755,3537,1993,1544,346,41,1,40,504,33,20,13,4393,2184,1272,912
425,104195,6330,3073,3257,0500000US13073,13073,"Columbia County, Georgia",Columbia County, Georgia,25716,2571,1355,1216,7537,193,89,104,0,0,0,0,10599,422,256,166,6293,449,208,241,387,108,89,19,1866,28,6,22
426,10881,1760,671,1089,0500000US13075,13075,"Cook County, Georgia",Cook County, Georgia,4685,1561,608,953,406,41,20,21,0,0,0,0,961,198,56,142,151,0,0,0,0,0,0,0,133,8,8,0
427,102459,5885,2442,3443,0500000US13077,13077,"Coweta County, Georgia",Coweta County, Georgia,25230,3844,1800,2044,4902,839,379,460,24,0,0,0,10327,2407,1231,1176,2918,131,121,10,305,56,0,56,2437,744,413,331
428,8909,1217,601,616,0500000US13079,13079,"Crawford County, Georgia",Crawford County, Georgia,2665,672,263,409,166,25,5,20,0,0,0,0,424,97,83,14,15,0,0,0,16,0,0,0,209,0,0,0
429,10844,1215,492,723,0500000US13081,13081,"Crisp County, Georgia",Crisp County, Georgia,10056,4956,2274,2682,286,66,33,33,23,23,0,23,785,322,159,163,20,1,1,0,0,0,0,0,42,0,0,0
430,13848,1497,614,883,0500000US13083,13083,"Dade County, Georgia",Dade County, Georgia,112,12,12,0,439,51,23,28,21,21,8,13,317,52,22,30,194,4,4,0,0,0,0,0,66,22,5,17
431,22882,2268,1124,1144,0500000US13085,13085,"Dawson County, Georgia",Dawson County, Georgia,111,36,22,14,850,0,0,0,0,0,0,0,1157,0,0,0,179,81,53,28,26,0,0,0,91,0,0,0
432,12731,1786,807,979,0500000US13087,13087,"Decatur County, Georgia",Decatur County, Georgia,10463,3399,1237,2162,312,229,50,179,0,0,0,0,1595,833,352,481,179,0,0,0,38,0,0,0,1026,228,57,171
433,214893,12660,6275,6385,0500000US13089,13089,"DeKalb County, Georgia",DeKalb County, Georgia,396122,68134,28809,39325,32279,5933,2737,3196,503,164,65,99,62356,13647,6248,7399,45360,8176,3716,4460,6579,1837,912,925,13411,3605,1342,2263
434,12683,2059,844,1215,0500000US13091,13091,"Dodge County, Georgia",Dodge County, Georgia,4855,1390,550,840,289,78,32,46,0,0,0,0,679,137,77,60,48,1,1,0,13,0,0,0,160,56,36,20
435,5209,541,192,349,0500000US13093,13093,"Dooly County, Georgia",Dooly County, Georgia,5913,1789,806,983,388,272,139,133,0,0,0,0,879,391,180,211,0,0,0,0,4,0,0,0,244,4,4,0
436,21159,2743,1159,1584,0500000US13095,13095,"Dougherty County, Georgia",Dougherty County, Georgia,59049,18861,8031,10830,1719,621,322,299,40,14,0,14,2453,931,412,519,840,117,61,56,116,10,0,10,1141,596,356,240
437,55615,6121,2441,3680,0500000US13097,13097,"Douglas County, Georgia",Douglas County, Georgia,68142,7576,3834,3742,4778,499,186,313,13,0,0,0,14209,2225,1228,997,2489,79,14,65,121,0,0,0,3869,653,166,487
438,4487,943,282,661,0500000US13099,13099,"Early County, Georgia",Early County, Georgia,5111,2063,518,1545,277,78,53,25,0,0,0,0,231,115,67,48,52,14,6,8,47,34,0,34,54,0,0,0
439,2331,329,118,211,0500000US13101,13101,"Echols County, Georgia",Echols County, Georgia,140,8,8,0,431,8,8,0,0,0,0,0,1108,582,281,301,0,0,0,0,64,0,0,0,672,509,238,271
440,47559,3061,1439,1622,0500000US13103,13103,"Effingham County, Georgia",Effingham County, Georgia,8282,898,292,606,2384,0,0,0,52,0,0,0,2935,505,130,375,415,0,0,0,110,36,18,18,872,342,104,238
441,11937,2283,886,1397,0500000US13105,13105,"Elbert County, Georgia",Elbert County, Georgia,5600,1747,788,959,390,66,19,47,0,0,0,0,1106,373,154,219,123,98,42,56,27,0,0,0,228,228,58,170
442,12938,2842,1254,1588,0500000US13107,13107,"Emanuel County, Georgia",Emanuel County, Georgia,7080,2057,869,1188,681,294,215,79,0,0,0,0,1025,91,76,15,38,0,0,0,48,0,0,0,232,1,1,0
443,5732,743,331,412,0500000US13109,13109,"Evans County, Georgia",Evans County, Georgia,2803,1019,511,508,252,45,25,20,0,0,0,0,1241,579,303,276,101,0,0,0,32,0,0,0,1036,571,303,268
444,24028,2547,1030,1517,0500000US13111,13111,"Fannin County, Georgia",Fannin County, Georgia,14,5,2,3,609,82,58,24,35,0,0,0,645,105,62,43,79,7,7,0,26,15,15,0,295,24,10,14
445,68179,3007,1088,1919,0500000US13113,13113,"Fayette County, Georgia",Fayette County, Georgia,26351,904,368,536,4668,506,179,327,196,0,0,0,8137,548,207,341,4968,141,45,96,166,10,10,0,3546,437,225,212
446,65929,8826,3754,5072,0500000US13115,13115,"Floyd County, Georgia",Floyd County, Georgia,12586,3800,1616,2184,3413,1027,664,363,19,19,0,19,10867,3307,1651,1656,1039,245,74,171,145,41,41,0,2915,1080,591,489
447,164431,6392,2808,3584,0500000US13117,13117,"Forsyth County, Georgia",Forsyth County, Georgia,8349,443,202,241,9768,1279,410,869,49,0,0,0,22259,4117,1552,2565,33873,867,350,517,691,45,0,45,4782,805,425,380
448,18769,3686,1752,1934,0500000US13119,13119,"Franklin County, Georgia",Franklin County, Georgia,1865,548,266,282,458,119,71,48,0,0,0,0,1089,285,169,116,264,66,66,0,74,31,14,17,502,173,109,64
449,402740,22527,10414,12113,0500000US13121,13121,"Fulton County, Georgia",Fulton County, Georgia,443257,91940,39166,52774,35425,4482,1978,2504,407,57,57,0,72987,11861,5579,6282,73054,6441,3617,2824,3874,1023,515,508,18010,3474,1858,1616
450,26437,3600,1878,1722,0500000US13123,13123,"Gilmer County, Georgia",Gilmer County, Georgia,86,0,0,0,764,78,53,25,3,3,3,0,3583,940,389,551,98,24,18,6,327,149,70,79,1090,477,222,255
451,2562,493,229,264,0500000US13125,13125,"Glascock County, Georgia",Glascock County, Georgia,253,26,15,11,27,6,0,6,1,0,0,0,49,0,0,0,0,0,0,0,14,0,0,0,0,0,0,0
452,52923,5193,2335,2858,0500000US13127,13127,"Glynn County, Georgia",Glynn County, Georgia,21002,6019,2264,3755,3008,641,316,325,94,31,0,31,5591,2396,1332,1064,1266,91,0,91,203,49,49,0,1126,164,116,48
453,44031,5821,2240,3581,0500000US13129,13129,"Gordon County, Georgia",Gordon County, Georgia,2214,207,112,95,2021,214,18,196,77,55,30,25,9249,2766,1177,1589,694,190,54,136,715,88,34,54,2905,771,333,438
454,14235,1909,843,1066,0500000US13131,13131,"Grady County, Georgia",Grady County, Georgia,7039,1685,861,824,1181,525,323,202,11,0,0,0,2758,832,448,384,152,12,0,12,116,0,0,0,71,0,0,0
455,10247,998,309,689,0500000US13133,13133,"Greene County, Georgia",Greene County, Georgia,6079,1223,697,526,273,115,80,35,4,4,4,0,1085,589,308,281,192,37,14,23,0,0,0,0,691,454,225,229
456,332235,19540,8559,10981,0500000US13135,13135,"Gwinnett County, Georgia",Gwinnett County, Georgia,257044,27246,12119,15127,49415,7523,3368,4155,412,15,2,13,195773,35656,16416,19240,112476,12022,5527,6495,3545,429,237,192,79131,14576,6622,7954
457,32986,3983,1671,2312,0500000US13137,13137,"Habersham County, Georgia",Habersham County, Georgia,667,226,113,113,1886,274,109,165,321,0,0,0,6944,1297,628,669,943,222,47,175,73,6,6,0,2255,655,393,262
458,120430,10080,4283,5797,0500000US13139,13139,"Hall County, Georgia",Hall County, Georgia,14028,2180,1079,1101,12124,2391,951,1440,21,0,0,0,57049,15242,7087,8155,3800,77,60,17,515,150,84,66,7903,2275,1359,916
459,1615,68,35,33,0500000US13141,13141,"Hancock County, Georgia",Hancock County, Georgia,4339,1431,384,1047,12,0,0,0,0,0,0,0,20,1,1,0,118,0,0,0,0,0,0,0,0,0,0,0
460,26477,3254,1231,2023,0500000US13143,13143,"Haralson County, Georgia",Haralson County, Georgia,1192,155,77,78,630,182,152,30,0,0,0,0,562,87,38,49,248,34,3,31,40,6,6,0,171,0,0,0
461,26218,1330,555,775,0500000US13145,13145,"Harris County, Georgia",Harris County, Georgia,5336,474,175,299,1059,36,3,33,2,0,0,0,1247,113,55,58,228,10,10,0,36,0,0,0,343,0,0,0
462,18769,2176,1050,1126,0500000US13147,13147,"Hart County, Georgia",Hart County, Georgia,4819,1033,442,591,391,76,76,0,0,0,0,0,929,149,61,88,246,0,0,0,147,38,0,38,84,27,15,12
463,9873,1933,805,1128,0500000US13149,13149,"Heard County, Georgia",Heard County, Georgia,956,145,78,67,368,143,85,58,16,0,0,0,321,118,62,56,97,0,0,0,0,0,0,0,28,0,0,0
464,93791,6220,2867,3353,0500000US13151,13151,"Henry County, Georgia",Henry County, Georgia,104177,10485,4334,6151,8860,914,305,609,0,0,0,0,16168,2572,1291,1281,7762,1287,655,632,226,39,26,13,3664,306,257,49
465,85054,6066,2289,3777,0500000US13153,13153,"Houston County, Georgia",Houston County, Georgia,47751,7216,3302,3914,6446,1513,760,753,276,0,0,0,10046,2780,1389,1391,5205,650,264,386,935,182,57,125,1496,248,107,141
466,6149,799,357,442,0500000US13155,13155,"Irwin County, Georgia",Irwin County, Georgia,2661,1151,655,496,17,0,0,0,0,0,0,0,368,93,93,0,39,0,0,0,34,0,0,0,16,0,0,0
467,56358,4679,1977,2702,0500000US13157,13157,"Jackson County, Georgia",Jackson County, Georgia,4765,761,351,410,2318,265,87,178,19,0,0,0,5669,946,479,467,1250,1,0,1,4,0,0,0,1752,296,167,129
468,10327,1527,674,853,0500000US13159,13159,"Jasper County, Georgia",Jasper County, Georgia,2721,465,242,223,262,101,60,41,0,0,0,0,484,27,0,27,23,0,0,0,15,0,0,0,409,0,0,0
469,10640,2316,710,1606,0500000US13161,13161,"Jeff Davis County, Georgia",Jeff Davis County, Georgia,2441,378,176,202,574,54,11,43,0,0,0,0,1848,347,171,176,38,0,0,0,0,0,0,0,551,57,13,44
470,6228,637,196,441,0500000US13163,13163,"Jefferson County, Georgia",Jefferson County, Georgia,7995,2361,962,1399,160,17,13,4,0,0,0,0,596,148,89,59,58,7,1,6,17,0,0,0,255,117,83,34
471,4768,888,396,492,0500000US13165,13165,"Jenkins County, Georgia",Jenkins County, Georgia,2662,1319,562,757,83,80,0,80,0,0,0,0,547,479,247,232,63,0,0,0,183,183,0,183,186,186,148,38
472,5625,989,345,644,0500000US13167,13167,"Johnson County, Georgia",Johnson County, Georgia,2885,840,412,428,150,78,6,72,0,0,0,0,192,157,49,108,19,0,0,0,0,0,0,0,6,6,6,0
473,20163,2711,1173,1538,0500000US13169,13169,"Jones County, Georgia",Jones County, Georgia,6859,541,331,210,608,34,34,0,0,0,0,0,501,12,12,0,168,11,0,11,46,0,0,0,92,0,0,0
474,11721,1560,691,869,0500000US13171,13171,"Lamar County, Georgia",Lamar County, Georgia,4575,888,262,626,481,53,0,53,0,0,0,0,441,99,99,0,58,0,0,0,0,0,0,0,118,47,47,0
475,7001,1439,696,743,0500000US13173,13173,"Lanier County, Georgia",Lanier County, Georgia,2310,1158,411,747,330,6,6,0,0,0,0,0,662,306,55,251,50,0,0,0,15,0,0,0,50,21,0,21
476,26476,4984,2238,2746,0500000US13175,13175,"Laurens County, Georgia",Laurens County, Georgia,17258,6192,2733,3459,363,84,32,52,9,9,9,0,1203,433,216,217,520,168,68,100,108,0,0,0,1097,575,306,269
477,20595,1857,933,924,0500000US13177,13177,"Lee County, Georgia",Lee County, Georgia,5753,1178,616,562,940,96,25,71,41,10,0,10,855,68,0,68,676,262,112,150,35,0,0,0,151,36,0,36
478,22579,2411,910,1501,0500000US13179,13179,"Liberty County, Georgia",Liberty County, Georgia,24686,3758,1347,2411,5230,1242,416,826,318,31,7,24,7435,1520,660,860,1125,66,34,32,313,103,50,53,2331,477,142,335
479,5222,721,375,346,0500000US13181,13181,"Lincoln County, Georgia",Lincoln County, Georgia,2336,770,313,457,102,57,22,35,3,0,0,0,151,23,9,14,8,0,0,0,0,0,0,0,73,6,6,0
480,10715,2339,834,1505,0500000US13183,13183,"Long County, Georgia",Long County, Georgia,4744,543,211,332,1222,264,61,203,67,0,0,0,2189,712,234,478,129,56,42,14,45,11,7,4,1194,579,193,386
481,59915,7560,3299,4261,0500000US13185,13185,"Lowndes County, Georgia",Lowndes County, Georgia,40973,14548,6222,8326,3356,653,338,315,138,75,0,75,6512,2323,1160,1163,1686,457,291,166,608,409,221,188,2447,963,507,456
482,28710,4106,1834,2272,0500000US13187,13187,"Lumpkin County, Georgia",Lumpkin County, Georgia,523,24,11,13,390,151,71,80,25,0,0,0,1528,168,77,91,263,0,0,0,127,0,0,0,347,0,0,0
483,11282,1631,809,822,0500000US13189,13189,"McDuffie County, Georgia",McDuffie County, Georgia,8408,1762,594,1168,483,109,24,85,244,244,143,101,674,264,114,150,88,24,0,24,0,0,0,0,569,240,90,150
484,8662,936,382,554,0500000US13191,13191,"McIntosh County, Georgia",McIntosh County, Georgia,4881,1159,663,496,178,2,2,0,0,0,0,0,59,0,0,0,240,0,0,0,13,0,0,0,0,0,0,0
485,3695,245,120,125,0500000US13193,13193,"Macon County, Georgia",Macon County, Georgia,6537,2282,901,1381,65,4,2,2,0,0,0,0,506,404,125,279,11,0,0,0,0,0,0,0,452,431,124,307
486,23600,3700,1415,2285,0500000US13195,13195,"Madison County, Georgia",Madison County, Georgia,2541,900,397,503,684,25,8,17,0,0,0,0,1710,957,318,639,375,155,132,23,62,0,0,0,1079,795,276,519
487,4910,586,271,315,0500000US13197,13197,"Marion County, Georgia",Marion County, Georgia,2519,476,194,282,235,0,0,0,35,0,0,0,653,22,0,22,101,87,16,71,11,11,0,11,395,22,0,22
488,11792,1780,725,1055,0500000US13199,13199,"Meriwether County, Georgia",Meriwether County, Georgia,8455,2475,1027,1448,148,13,0,13,0,0,0,0,487,90,90,0,52,0,0,0,12,12,0,12,150,98,94,4
489,3804,547,173,374,0500000US13201,13201,"Miller County, Georgia",Miller County, Georgia,1671,580,244,336,24,0,0,0,28,0,0,0,31,0,0,0,6,0,0,0,12,0,0,0,0,0,0,0
490,9326,1556,630,926,0500000US13205,13205,"Mitchell County, Georgia",Mitchell County, Georgia,9045,3127,1024,2103,644,235,177,58,55,0,0,0,629,370,238,132,80,0,0,0,48,0,0,0,129,100,100,0
491,19359,2626,1341,1285,0500000US13207,13207,"Monroe County, Georgia",Monroe County, Georgia,5687,1312,756,556,496,62,34,28,0,0,0,0,571,74,52,22,172,0,0,0,49,0,0,0,193,56,52,4
492,5603,676,224,452,0500000US13209,13209,"Montgomery County, Georgia",Montgomery County, Georgia,1921,574,203,371,81,10,1,9,0,0,0,0,589,103,46,57,21,0,0,0,0,0,0,0,449,99,42,57
493,13426,790,303,487,0500000US13211,13211,"Morgan County, Georgia",Morgan County, Georgia,4473,365,134,231,233,33,33,0,0,0,0,0,591,165,82,83,13,0,0,0,11,0,0,0,262,238,86,152
494,32054,4898,1965,2933,0500000US13213,13213,"Murray County, Georgia",Murray County, Georgia,271,24,20,4,855,167,50,117,0,0,0,0,6011,1178,573,605,115,0,0,0,68,41,16,25,184,19,17,2
495,74331,9600,4498,5102,0500000US13215,13215,"Muscogee County, Georgia",Muscogee County, Georgia,87878,23546,10749,12797,10143,1990,985,1005,278,92,44,48,14636,2793,1291,1502,4773,520,220,300,601,95,55,40,5444,1409,593,816
496,48721,6067,2757,3310,0500000US13217,13217,"Newton County, Georgia",Newton County, Georgia,49595,9069,3867,5202,2957,557,210,347,78,0,0,0,6203,709,236,473,1194,23,10,13,307,2,0,2,1887,171,82,89
497,32562,1560,589,971,0500000US13219,13219,"Oconee County, Georgia",Oconee County, Georgia,1878,208,87,121,1078,131,50,81,34,0,0,0,2126,507,301,206,1594,0,0,0,40,0,0,0,141,4,3,1
498,11254,1061,386,675,0500000US13221,13221,"Oglethorpe County, Georgia",Oglethorpe County, Georgia,2532,485,236,249,339,122,55,67,0,0,0,0,728,162,141,21,49,0,0,0,3,0,0,0,115,115,94,21
499,112906,7497,3238,4259,0500000US13223,13223,"Paulding County, Georgia",Paulding County, Georgia,32720,2384,951,1433,6802,494,207,287,35,0,0,0,10917,1262,512,750,1728,321,68,253,362,156,73,83,2014,233,91,142
500,12158,1556,625,931,0500000US13225,13225,"Peach County, Georgia",Peach County, Georgia,10916,3287,1513,1774,398,4,0,4,49,0,0,0,2113,524,279,245,202,1,1,0,122,0,0,0,941,127,40,87
501,27263,3184,1255,1929,0500000US13227,13227,"Pickens County, Georgia",Pickens County, Georgia,467,36,25,11,3096,417,270,147,0,0,0,0,998,113,113,0,92,0,0,0,265,0,0,0,7,0,0,0
502,16152,2135,962,1173,0500000US13229,13229,"Pierce County, Georgia",Pierce County, Georgia,1919,879,432,447,187,51,37,14,0,0,0,0,953,465,251,214,0,0,0,0,63,63,47,16,556,363,190,173
503,15851,1313,542,771,0500000US13231,13231,"Pike County, Georgia",Pike County, Georgia,1570,208,113,95,290,18,5,13,0,0,0,0,298,143,30,113,71,9,0,9,0,0,0,0,172,68,24,44
504,30140,2862,962,1900,0500000US13233,13233,"Polk County, Georgia",Polk County, Georgia,4752,1543,721,822,1858,1118,573,545,16,16,0,16,5551,2630,1577,1053,241,0,0,0,144,83,61,22,1566,262,134,128
505,5881,571,207,364,0500000US13235,13235,"Pulaski County, Georgia",Pulaski County, Georgia,3342,1293,718,575,18,0,0,0,0,0,0,0,307,52,11,41,77,0,0,0,45,45,0,45,11,0,0,0
506,14230,2177,829,1348,0500000US13237,13237,"Putnam County, Georgia",Putnam County, Georgia,5519,1602,706,896,433,164,66,98,0,0,0,0,1371,41,21,20,41,19,0,19,6,0,0,0,611,42,0,42
507,963,184,82,102,0500000US13239,13239,"Quitman County, Georgia",Quitman County, Georgia,1076,122,49,73,65,22,7,15,12,0,0,0,29,0,0,0,145,0,0,0,0,0,0,0,0,0,0,0
508,14619,2383,1144,1239,0500000US13241,13241,"Rabun County, Georgia",Rabun County, Georgia,242,94,34,60,204,31,8,23,2,0,0,0,1314,511,209,302,286,265,0,265,0,0,0,0,553,346,171,175
509,2123,269,119,150,0500000US13243,13243,"Randolph County, Georgia",Randolph County, Georgia,4266,1643,621,1022,125,55,37,18,0,0,0,0,152,2,0,2,3,3,3,0,0,0,0,0,104,0,0,0
510,64201,9423,4126,5297,0500000US13245,13245,"Richmond County, Georgia",Richmond County, Georgia,110731,31267,12934,18333,6208,1294,529,765,376,12,12,0,9149,2737,1059,1678,3631,769,460,309,340,28,7,21,3087,1038,248,790
511,26736,2276,933,1343,0500000US13247,13247,"Rockdale County, Georgia",Rockdale County, Georgia,49881,5424,2287,3137,3749,486,131,355,162,0,0,0,9128,2630,1180,1450,1744,138,75,63,76,0,0,0,1676,366,141,225
512,3388,243,70,173,0500000US13249,13249,"Schley County, Georgia",Schley County, Georgia,1427,506,166,340,146,0,0,0,0,0,0,0,330,23,12,11,0,0,0,0,0,0,0,0,137,8,8,0
513,7391,1336,736,600,0500000US13251,13251,"Screven County, Georgia",Screven County, Georgia,5515,1276,349,927,215,81,64,17,0,0,0,0,307,24,0,24,109,0,0,0,44,44,15,29,82,0,0,0
514,4959,873,363,510,0500000US13253,13253,"Seminole County, Georgia",Seminole County, Georgia,2871,1176,343,833,140,12,0,12,0,0,0,0,101,12,0,12,94,77,77,0,0,0,0,0,14,0,0,0
515,37517,4008,1337,2671,0500000US13255,13255,"Spalding County, Georgia",Spalding County, Georgia,22069,6289,2473,3816,1423,257,174,83,0,0,0,0,3055,728,534,194,694,57,18,39,256,9,9,0,309,98,90,8
516,20568,2552,665,1887,0500000US13257,13257,"Stephens County, Georgia",Stephens County, Georgia,2730,494,359,135,695,356,135,221,2,2,2,0,875,64,46,18,123,0,0,0,29,0,0,0,609,0,0,0
517,1231,111,52,59,0500000US13259,13259,"Stewart County, Georgia",Stewart County, Georgia,2863,1076,567,509,65,0,0,0,0,0,0,0,56,24,0,24,41,0,0,0,0,0,0,0,4,0,0,0
518,10913,1708,600,1108,0500000US13261,13261,"Sumter County, Georgia",Sumter County, Georgia,14608,4532,1656,2876,289,63,34,29,0,0,0,0,1583,429,159,270,359,2,2,0,6,0,0,0,317,100,54,46
519,2508,416,202,214,0500000US13263,13263,"Talbot County, Georgia",Talbot County, Georgia,3516,517,248,269,72,0,0,0,0,0,0,0,49,0,0,0,36,0,0,0,4,2,2,0,48,24,0,24
520,582,67,23,44,0500000US13265,13265,"Taliaferro County, Georgia",Taliaferro County, Georgia,934,300,147,153,0,0,0,0,8,8,0,8,70,19,9,10,0,0,0,0,0,0,0,0,53,0,0,0
521,12825,2165,813,1352,0500000US13267,13267,"Tattnall County, Georgia",Tattnall County, Georgia,3459,1076,437,639,411,43,6,37,0,0,0,0,2555,825,207,618,0,0,0,0,45,0,0,0,2284,896,237,659
522,4571,1088,344,744,0500000US13269,13269,"Taylor County, Georgia",Taylor County, Georgia,3020,969,503,466,53,9,3,6,0,0,0,0,55,0,0,0,275,275,158,117,0,0,0,0,0,0,0,0
523,7210,1410,509,901,0500000US13271,13271,"Telfair County, Georgia",Telfair County, Georgia,4996,1734,808,926,319,311,294,17,0,0,0,0,348,284,270,14,16,0,0,0,0,0,0,0,16,0,0,0
524,2944,496,291,205,0500000US13273,13273,"Terrell County, Georgia",Terrell County, Georgia,4822,1869,781,1088,45,25,7,18,0,0,0,0,243,16,8,8,267,188,79,109,16,16,8,8,184,0,0,0
525,25181,2722,1167,1555,0500000US13275,13275,"Thomas County, Georgia",Thomas County, Georgia,16170,4202,1691,2511,796,173,85,88,25,25,25,0,1667,489,269,220,90,31,25,6,67,43,36,7,455,164,65,99
526,20678,3065,1564,1501,0500000US13277,13277,"Tift County, Georgia",Tift County, Georgia,11507,3926,1451,2475,1510,160,117,43,1,0,0,0,4787,1417,677,740,506,4,1,3,83,35,14,21,1244,687,433,254
527,15855,1902,702,1200,0500000US13279,13279,"Toombs County, Georgia",Toombs County, Georgia,6847,2101,858,1243,696,386,147,239,0,0,0,0,3028,1296,697,599,198,0,0,0,7,7,7,0,1297,534,287,247
528,10451,1295,580,715,0500000US13281,13281,"Towns County, Georgia",Towns County, Georgia,76,0,0,0,191,26,13,13,0,0,0,0,277,41,6,35,54,14,0,14,38,21,0,21,31,0,0,0
529,4527,1316,669,647,0500000US13283,13283,"Treutlen County, Georgia",Treutlen County, Georgia,1763,677,328,349,10,10,0,10,0,0,0,0,100,0,0,0,0,0,0,0,0,0,0,0,0,0,0,0
530,38331,5649,2369,3280,0500000US13285,13285,"Troup County, Georgia",Troup County, Georgia,24729,6617,2693,3924,1307,237,53,184,0,0,0,0,2569,689,335,354,1520,206,104,102,147,51,0,51,774,479,276,203
531,4044,718,313,405,0500000US13287,13287,"Turner County, Georgia",Turner County, Georgia,3019,1401,495,906,149,35,17,18,0,0,0,0,382,127,70,57,58,0,0,0,0,0,0,0,47,0,0,0
532,4463,499,232,267,0500000US13289,13289,"Twiggs County, Georgia",Twiggs County, Georgia,3420,645,382,263,88,66,0,66,0,0,0,0,128,0,0,0,13,0,0,0,28,28,28,0,0,0,0,0
533,22039,3182,1426,1756,0500000US13291,13291,"Union County, Georgia",Union County, Georgia,39,13,5,8,566,208,7,201,0,0,0,0,833,272,116,156,82,17,0,17,71,71,71,0,40,6,6,0
534,16977,2421,961,1460,0500000US13293,13293,"Upson County, Georgia",Upson County, Georgia,7098,2439,954,1485,386,72,42,30,201,176,101,75,610,85,47,38,105,0,0,0,164,0,0,0,267,0,0,0
535,61643,9294,4096,5198,0500000US13295,13295,"Walker County, Georgia",Walker County, Georgia,2435,509,243,266,1949,276,192,84,0,0,0,0,1568,6,0,6,550,134,90,44,81,0,0,0,224,0,0,0
536,68008,5274,2122,3152,0500000US13297,13297,"Walton County, Georgia",Walton County, Georgia,16688,4922,1785,3137,1576,342,218,124,16,0,0,0,4237,574,299,275,1527,233,64,169,68,14,14,0,1442,206,124,82
537,21373,4144,1585,2559,0500000US13299,13299,"Ware County, Georgia",Ware County, Georgia,9588,2708,1036,1672,683,414,212,202,43,0,0,0,1392,457,300,157,436,145,109,36,52,0,0,0,437,62,44,18
538,1950,240,153,87,0500000US13301,13301,"Warren County, Georgia",Warren County, Georgia,3165,1034,360,674,21,7,0,7,0,0,0,0,0,0,0,0,51,51,26,25,0,0,0,0,0,0,0,0
539,7952,799,309,490,0500000US13303,13303,"Washington County, Georgia",Washington County, Georgia,9630,2889,1164,1725,265,50,15,35,0,0,0,0,327,43,12,31,142,5,2,3,32,0,0,0,138,66,31,35
540,20411,2698,1130,1568,0500000US13305,13305,"Wayne County, Georgia",Wayne County, Georgia,5198,1528,618,910,817,214,67,147,0,0,0,0,1703,298,63,235,130,1,1,0,0,0,0,0,367,76,0,76
541,1371,73,28,45,0500000US13307,13307,"Webster County, Georgia",Webster County, Georgia,847,272,161,111,35,0,0,0,0,0,0,0,322,292,161,131,0,0,0,0,8,0,0,0,281,281,161,120
542,4351,1311,850,461,0500000US13309,13309,"Wheeler County, Georgia",Wheeler County, Georgia,2949,990,663,327,14,11,10,1,0,0,0,0,388,0,0,0,0,0,0,0,0,0,0,0,0,0,0,0
543,27210,3122,1212,1910,0500000US13311,13311,"White County, Georgia",White County, Georgia,632,22,21,1,459,72,16,56,1,1,1,0,974,78,59,19,166,35,31,4,184,0,0,0,191,48,48,0
544,59514,7213,3405,3808,0500000US13313,13313,"Whitfield County, Georgia",Whitfield County, Georgia,3347,750,364,386,4025,737,297,440,18,0,0,0,36767,7739,3312,4427,1428,326,117,209,996,621,308,313,4332,843,386,457
545,4642,764,359,405,0500000US13315,13315,"Wilcox County, Georgia",Wilcox County, Georgia,1733,777,179,598,18,2,0,2,1,0,0,0,251,115,56,59,0,0,0,0,9,7,4,3,26,3,3,0
546,4923,407,253,154,0500000US13317,13317,"Wilkes County, Georgia",Wilkes County, Georgia,4042,1436,654,782,160,0,0,0,0,0,0,0,509,320,236,84,0,0,0,0,8,0,0,0,298,179,131,48
547,5013,1033,516,517,0500000US13319,13319,"Wilkinson County, Georgia",Wilkinson County, Georgia,3459,998,373,625,94,56,19,37,3,3,0,3,235,79,38,41,0,0,0,0,8,4,0,4,39,22,17,5
548,13401,1829,780,1049,0500000US13321,13321,"Worth County, Georgia",Worth County, Georgia,5677,1764,599,1165,348,77,17,60,7,0,0,0,446,123,76,47,178,16,0,16,65,13,9,4,97,0,0,0
549,59433,7335,4078,3257,0500000US15001,15001,"Hawaii County, Hawaii",Hawaii County, Hawaii,1242,432,293,139,58679,9188,4366,4822,23528,5394,2386,3008,26129,4964,2575,2389,44932,3661,1677,1984,808,161,100,61,4000,209,139,70
550,163731,12125,5740,6385,0500000US15003,15003,"Honolulu County, Hawaii",Honolulu County, Hawaii,21655,1417,822,595,223502,18112,7622,10490,95136,20106,9198,10908,94214,10530,4705,5825,410029,24539,10091,14448,1661,361,179,182,10771,765,404,361
551,57,1,1,0,0500000US15005,15005,"Kalawao County, Hawaii",Kalawao County, Hawaii,3,0,0,0,11,1,1,0,271,0,0,0,1,0,0,0,10,3,2,1,77,0,0,0,0,0,0,0
552,20806,1905,1054,851,0500000US15007,15007,"Kauai County, Hawaii",Kauai County, Hawaii,349,36,11,25,17670,819,425,394,6482,1299,458,841,8082,661,274,387,23088,1225,617,608,334,55,3,52,625,65,2,63
553,48731,5241,2767,2474,0500000US15009,15009,"Maui County, Hawaii",Maui County, Hawaii,938,142,78,64,38614,3051,1577,1474,18275,3316,1530,1786,19017,1704,739,965,47868,2067,928,1139,373,114,64,50,2894,207,90,117
554,389814,32597,15230,17367,0500000US16001,16001,"Ada County, Idaho",Ada County, Idaho,5783,1579,899,680,20372,1463,600,863,889,326,0,326,38206,5453,2216,3237,11902,1650,558,1092,2441,671,183,488,7319,1254,301,953
555,3834,637,324,313,0500000US16003,16003,"Adams County, Idaho",Adams County, Idaho,14,0,0,0,110,22,0,22,17,17,0,17,148,0,0,0,0,0,0,0,43,0,0,0,0,0,0,0
556,68914,8047,3533,4514,0500000US16005,16005,"Bannock County, Idaho",Bannock County, Idaho,416,52,10,42,3486,912,606,306,92,52,52,0,6791,1507,733,774,1681,331,106,225,1999,988,339,649,1707,526,269,257
557,5566,771,378,393,0500000US16007,16007,"Bear Lake County, Idaho",Bear Lake County, Idaho,18,0,0,0,151,3,0,3,0,0,0,0,245,79,38,41,29,0,0,0,49,40,15,25,94,36,23,13
558,7711,889,390,499,0500000US16009,16009,"Benewah County, Idaho",Benewah County, Idaho,22,3,3,0,294,41,23,18,65,4,0,4,349,33,18,15,21,15,0,15,814,250,114,136,15,0,0,0
559,33648,3151,1620,1531,0500000US16011,16011,"Bingham County, Idaho",Bingham County, Idaho,55,0,0,0,1928,295,217,78,40,5,0,5,8363,1135,723,412,183,0,0,0,2875,776,398,378,3371,543,295,248
560,16792,1441,686,755,0500000US16013,16013,"Blaine County, Idaho",Blaine County, Idaho,141,23,23,0,1024,29,0,29,52,1,0,1,5200,1400,604,796,117,43,0,43,212,0,0,0,665,134,0,134
561,6850,952,388,564,0500000US16015,16015,"Boise County, Idaho",Boise County, Idaho,23,4,4,0,263,9,9,0,9,0,0,0,369,9,0,9,91,0,0,0,39,7,0,7,48,4,0,4
562,40920,5097,2086,3011,0500000US16017,16017,"Bonner County, Idaho",Bonner County, Idaho,118,17,11,6,1489,140,54,86,33,0,0,0,1458,227,98,129,298,35,17,18,452,98,67,31,287,25,14,11
563,95772,8683,3551,5132,0500000US16019,16019,"Bonneville County, Idaho",Bonneville County, Idaho,508,52,17,35,3862,455,229,226,139,133,54,79,15299,2069,717,1352,1078,138,63,75,730,150,104,46,6617,716,237,479
564,10788,2127,1033,1094,0500000US16021,16021,"Boundary County, Idaho",Boundary County, Idaho,35,26,26,0,260,21,0,21,81,5,0,5,622,144,84,60,157,66,0,66,150,67,23,44,98,30,21,9
565,2448,516,268,248,0500000US16023,16023,"Butte County, Idaho",Butte County, Idaho,3,1,1,0,10,10,4,6,0,0,0,0,102,21,2,19,0,0,0,0,0,0,0,0,0,0,0,0
566,1011,132,61,71,0500000US16025,16025,"Camas County, Idaho",Camas County, Idaho,0,0,0,0,30,0,0,0,0,0,0,0,28,0,0,0,0,0,0,0,0,0,0,0,0,0,0,0
567,153778,15126,6735,8391,0500000US16027,16027,"Canyon County, Idaho",Canyon County, Idaho,664,174,152,22,11987,1678,799,879,789,148,47,101,56240,10881,5304,5577,1835,244,123,121,2122,232,108,124,25552,5367,2980,2387
568,6340,447,217,230,0500000US16029,16029,"Caribou County, Idaho",Caribou County, Idaho,0,0,0,0,156,69,42,27,0,0,0,0,436,8,0,8,4,0,0,0,18,17,0,17,258,0,0,0
569,16145,1437,624,813,0500000US16031,16031,"Cassia County, Idaho",Cassia County, Idaho,42,31,30,1,1072,87,27,60,14,1,1,0,6441,1095,505,590,170,16,16,0,235,0,0,0,1000,115,70,45
570,489,25,19,6,0500000US16033,16033,"Clark County, Idaho",Clark County, Idaho,8,8,8,0,0,0,0,0,0,0,0,0,347,54,32,22,0,0,0,0,41,0,0,0,87,6,0,6
571,7147,872,432,440,0500000US16035,16035,"Clearwater County, Idaho",Clearwater County, Idaho,39,0,0,0,186,29,10,19,11,5,0,5,290,16,1,15,54,0,0,0,144,16,7,9,58,4,0,4
572,3551,637,338,299,0500000US16037,16037,"Custer County, Idaho",Custer County, Idaho,5,5,5,0,466,28,0,28,0,0,0,0,291,23,0,23,3,0,0,0,19,10,0,10,60,0,0,0
573,18813,2435,1238,1197,0500000US16039,16039,"Elmore County, Idaho",Elmore County, Idaho,681,4,2,2,1573,134,59,75,161,137,76,61,4595,771,352,419,743,48,15,33,563,309,142,167,697,44,8,36
574,12368,1116,499,617,0500000US16041,16041,"Franklin County, Idaho",Franklin County, Idaho,16,0,0,0,362,84,33,51,0,0,0,0,927,211,121,90,15,1,0,1,111,54,25,29,316,57,57,0
575,10751,1148,454,694,0500000US16043,16043,"Fremont County, Idaho",Fremont County, Idaho,18,8,2,6,353,56,29,27,64,30,9,21,1488,440,145,295,21,0,0,0,14,7,3,4,193,43,25,18
576,15237,1922,930,992,0500000US16045,16045,"Gem County, Idaho",Gem County, Idaho,15,0,0,0,801,223,79,144,0,0,0,0,1509,401,128,273,99,0,0,0,150,27,0,27,976,158,70,88
577,10219,1265,517,748,0500000US16047,16047,"Gooding County, Idaho",Gooding County, Idaho,4,0,0,0,970,31,23,8,29,2,2,0,4465,1213,513,700,140,0,0,0,120,8,2,6,365,67,10,57
578,14526,1705,807,898,0500000US16049,16049,"Idaho County, Idaho",Idaho County, Idaho,23,22,20,2,260,24,14,10,4,4,0,4,494,90,64,26,88,1,1,0,591,24,7,17,93,46,33,13
579,25279,1637,597,1040,0500000US16051,16051,"Jefferson County, Idaho",Jefferson County, Idaho,4,0,0,0,839,23,19,4,5,0,0,0,3073,689,395,294,144,34,34,0,352,18,18,0,1539,376,188,188
580,14478,1620,796,824,0500000US16053,16053,"Jerome County, Idaho",Jerome County, Idaho,41,0,0,0,1255,29,13,16,142,68,45,23,8796,2526,968,1558,184,82,44,38,134,0,0,0,981,355,144,211
581,142481,14195,5935,8260,0500000US16055,16055,"Kootenai County, Idaho",Kootenai County, Idaho,551,58,49,9,6843,939,337,602,160,32,10,22,7685,778,326,452,1334,185,51,134,2019,489,226,263,1659,41,37,4
582,32555,5392,2616,2776,0500000US16057,16057,"Latah County, Idaho",Latah County, Idaho,441,63,0,63,1325,478,273,205,28,4,4,0,1545,547,251,296,645,202,172,30,491,37,7,30,200,140,52,88
583,7326,978,372,606,0500000US16059,16059,"Lemhi County, Idaho",Lemhi County, Idaho,0,0,0,0,352,85,65,20,2,0,0,0,225,27,27,0,0,0,0,0,15,0,0,0,93,0,0,0
584,3134,394,171,223,0500000US16061,16061,"Lewis County, Idaho",Lewis County, Idaho,21,17,9,8,172,11,7,4,1,1,0,1,185,35,3,32,49,5,0,5,262,127,87,40,112,32,0,32
585,3462,313,146,167,0500000US16063,16063,"Lincoln County, Idaho",Lincoln County, Idaho,0,0,0,0,392,20,19,1,0,0,0,0,1648,330,231,99,30,0,0,0,33,3,0,3,156,4,3,1
586,34702,8658,3735,4923,0500000US16065,16065,"Madison County, Idaho",Madison County, Idaho,88,68,68,0,1373,635,478,157,101,47,14,33,3033,1424,820,604,576,107,18,89,59,1,1,0,998,442,248,194
587,12736,1168,505,663,0500000US16067,16067,"Minidoka County, Idaho",Minidoka County, Idaho,29,0,0,0,1135,514,273,241,35,0,0,0,7291,2024,973,1051,79,0,0,0,175,61,19,42,812,207,114,93
588,34311,3886,1711,2175,0500000US16069,16069,"Nez Perce County, Idaho",Nez Perce County, Idaho,20,0,0,0,1077,218,127,91,25,20,20,0,1612,397,116,281,352,106,66,40,2350,623,268,355,204,28,15,13
589,4076,536,193,343,0500000US16071,16071,"Oneida County, Idaho",Oneida County, Idaho,4,0,0,0,76,0,0,0,0,0,0,0,195,0,0,0,0,0,0,0,17,0,0,0,33,0,0,0
590,7955,619,284,335,0500000US16073,16073,"Owyhee County, Idaho",Owyhee County, Idaho,45,0,0,0,669,148,73,75,0,0,0,0,3031,838,464,374,16,13,6,7,321,98,52,46,1557,428,297,131
591,18146,2013,854,1159,0500000US16075,16075,"Payette County, Idaho",Payette County, Idaho,14,0,0,0,1310,249,67,182,10,0,0,0,4010,656,363,293,214,53,14,39,143,57,40,17,1722,358,232,126
592,4649,542,227,315,0500000US16077,16077,"Power County, Idaho",Power County, Idaho,2,2,0,2,194,2,0,2,0,0,0,0,2590,202,94,108,0,0,0,0,491,167,137,30,848,34,34,0
593,11345,1506,650,856,0500000US16079,16079,"Shoshone County, Idaho",Shoshone County, Idaho,110,38,38,0,376,131,28,103,17,17,0,17,469,159,81,78,2,0,0,0,341,127,59,68,33,0,0,0
594,9549,561,251,310,0500000US16081,16081,"Teton County, Idaho",Teton County, Idaho,0,0,0,0,443,108,27,81,0,0,0,0,1908,230,58,172,0,0,0,0,114,0,0,0,598,0,0,0
595,66137,7128,3337,3791,0500000US16083,16083,"Twin Falls County, Idaho",Twin Falls County, Idaho,671,341,76,265,3890,1043,603,440,21,0,0,0,14137,2975,1596,1379,1586,298,184,114,639,84,4,80,2931,793,474,319
596,10321,880,304,576,0500000US16085,16085,"Valley County, Idaho",Valley County, Idaho,4,4,4,0,92,1,0,1,0,0,0,0,509,4,3,1,10,0,0,0,44,0,0,0,46,1,1,0
597,7918,938,331,607,0500000US16087,16087,"Washington County, Idaho",Washington County, Idaho,3,0,0,0,395,4,0,4,26,0,0,0,1700,264,75,189,29,12,0,12,51,8,0,8,878,145,25,120
598,58857,6678,2983,3695,0500000US17001,17001,"Adams County, Illinois",Adams County, Illinois,2536,745,352,393,1409,443,245,198,8,2,0,2,995,102,63,39,463,68,19,49,120,6,0,6,197,12,6,6
599,3676,823,355,468,0500000US17003,17003,"Alexander County, Illinois",Alexander County, Illinois,2074,735,273,462,65,9,5,4,28,0,0,0,62,14,14,0,2,0,0,0,6,0,0,0,0,0,0,0
600,13498,1666,900,766,0500000US17005,17005,"Bond County, Illinois",Bond County, Illinois,564,289,226,63,75,6,6,0,0,0,0,0,403,37,25,12,40,11,0,11,179,2,2,0,25,0,0,0
601,38257,2573,1133,1440,0500000US17007,17007,"Boone County, Illinois",Boone County, Illinois,1389,157,72,85,1888,164,51,113,0,0,0,0,11764,1564,456,1108,530,0,0,0,93,0,0,0,3695,668,191,477
602,4415,476,170,306,0500000US17009,17009,"Brown County, Illinois",Brown County, Illinois,0,0,0,0,69,4,4,0,0,0,0,0,216,27,0,27,0,0,0,0,28,0,0,0,38,0,0,0
603,28154,3303,1475,1828,0500000US17011,17011,"Bureau County, Illinois",Bureau County, Illinois,253,78,30,48,797,101,58,43,3,0,0,0,3039,488,230,258,241,19,7,12,79,15,8,7,930,87,56,31
604,4521,399,213,186,0500000US17013,17013,"Calhoun County, Illinois",Calhoun County, Illinois,0,0,0,0,50,19,6,13,0,0,0,0,57,21,8,13,50,0,0,0,15,3,3,0,2,2,2,0
605,13071,1352,560,792,0500000US17015,17015,"Carroll County, Illinois",Carroll County, Illinois,84,34,6,28,174,31,13,18,0,0,0,0,412,88,45,43,70,5,1,4,7,1,0,1,46,18,6,12
606,9080,1055,428,627,0500000US17017,17017,"Cass County, Illinois",Cass County, Illinois,518,229,117,112,331,19,1,18,72,0,0,0,2368,538,222,316,9,5,0,5,23,4,2,2,497,84,12,72
607,130153,18254,8833,9421,0500000US17019,17019,"Champaign County, Illinois",Champaign County, Illinois,26670,7620,3388,4232,7363,1639,601,1038,80,0,0,0,11128,2746,1273,1473,20350,7194,3706,3488,269,118,77,41,1886,532,221,311
608,29834,3066,1094,1972,0500000US17021,17021,"Christian County, Illinois",Christian County, Illinois,259,118,44,74,245,64,0,64,95,0,0,0,339,2,0,2,201,0,0,0,62,49,49,0,2,0,0,0
609,14801,1289,494,795,0500000US17023,17023,"Clark County, Illinois",Clark County, Illinois,75,34,9,25,259,9,9,0,0,0,0,0,245,0,0,0,50,0,0,0,14,0,0,0,62,0,0,0
610,12452,2098,1017,1081,0500000US17025,17025,"Clay County, Illinois",Clay County, Illinois,38,25,13,12,333,34,34,0,0,0,0,0,31,12,3,9,72,4,4,0,33,2,1,1,3,3,3,0
611,33234,2419,1222,1197,0500000US17027,17027,"Clinton County, Illinois",Clinton County, Illinois,249,4,2,2,786,136,80,56,0,0,0,0,1021,228,175,53,205,1,1,0,65,0,0,0,213,27,13,14
612,43817,8519,3966,4553,0500000US17029,17029,"Coles County, Illinois",Coles County, Illinois,1223,538,308,230,890,343,131,212,19,3,0,3,1129,187,124,63,495,157,25,132,69,1,1,0,159,25,9,16
613,2129919,159369,70135,89234,0500000US17031,17031,"Cook County, Illinois",Cook County, Illinois,1174506,283664,120921,162743,251969,31119,14483,16636,1866,296,101,195,1295854,196540,87591,108949,379439,43749,19362,24387,15856,2317,948,1369,492503,82715,36438,46277
614,16076,1851,827,1024,0500000US17033,17033,"Crawford County, Illinois",Crawford County, Illinois,75,12,10,2,172,10,5,5,0,0,0,0,107,18,11,7,20,0,0,0,8,0,0,0,39,3,0,3
615,10256,1105,506,599,0500000US17035,17035,"Cumberland County, Illinois",Cumberland County, Illinois,0,0,0,0,232,30,21,9,0,0,0,0,97,69,64,5,19,2,2,0,6,0,0,0,80,60,60,0
616,77131,9656,4324,5332,0500000US17037,17037,"DeKalb County, Illinois",DeKalb County, Illinois,6524,2620,1118,1502,3934,603,407,196,34,0,0,0,11373,2281,1120,1161,2105,1080,712,368,137,81,6,75,3455,586,360,226
617,14689,1457,591,866,0500000US17039,17039,"De Witt County, Illinois",De Witt County, Illinois,27,3,0,3,305,47,37,10,0,0,0,0,428,111,54,57,4,0,0,0,1,0,0,0,65,0,0,0
618,17314,1677,662,1015,0500000US17041,17041,"Douglas County, Illinois",Douglas County, Illinois,149,56,40,16,496,84,22,62,17,0,0,0,1392,271,127,144,121,21,21,0,95,3,0,3,98,6,6,0
619,603558,25949,11344,14605,0500000US17043,17043,"DuPage County, Illinois",DuPage County, Illinois,44556,7122,3064,4058,41799,3388,1345,2043,393,15,5,10,131097,13826,6222,7604,112082,7616,3724,3892,1631,61,14,47,32662,4522,1923,2599
620,16479,1872,708,1164,0500000US17045,17045,"Edgar County, Illinois",Edgar County, Illinois,86,11,7,4,135,22,22,0,3,3,0,3,210,22,22,0,95,0,0,0,25,0,0,0,89,0,0,0
621,6083,711,269,442,0500000US17047,17047,"Edwards County, Illinois",Edwards County, Illinois,28,13,13,0,113,38,27,11,0,0,0,0,88,16,7,9,16,0,0,0,28,0,0,0,12,0,0,0
622,32077,3456,1386,2070,0500000US17049,17049,"Effingham County, Illinois",Effingham County, Illinois,232,32,12,20,450,111,53,58,0,0,0,0,719,156,67,89,125,0,0,0,47,0,0,0,279,26,26,0
623,19219,3122,1485,1637,0500000US17051,17051,"Fayette County, Illinois",Fayette County, Illinois,105,39,39,0,159,45,21,24,25,0,0,0,153,0,0,0,114,0,0,0,33,0,0,0,0,0,0,0
624,11868,1433,584,849,0500000US17053,17053,"Ford County, Illinois",Ford County, Illinois,110,27,25,2,180,19,1,18,0,0,0,0,452,141,51,90,94,0,0,0,67,19,4,15,274,132,52,80
625,36291,6684,2945,3739,0500000US17055,17055,"Franklin County, Illinois",Franklin County, Illinois,205,83,44,39,592,132,58,74,17,4,4,0,654,260,137,123,201,88,47,41,67,18,0,18,150,102,42,60
626,30771,4425,2050,2375,0500000US17057,17057,"Fulton County, Illinois",Fulton County, Illinois,272,42,8,34,405,118,46,72,17,0,0,0,604,133,111,22,53,1,1,0,72,0,0,0,115,0,0,0
627,4747,1011,421,590,0500000US17059,17059,"Gallatin County, Illinois",Gallatin County, Illinois,18,18,18,0,153,89,26,63,0,0,0,0,54,1,0,1,6,0,0,0,0,0,0,0,14,0,0,0
628,12380,1593,784,809,0500000US17061,17061,"Greene County, Illinois",Greene County, Illinois,35,2,2,0,123,34,28,6,4,0,0,0,137,28,14,14,14,0,0,0,1,0,0,0,65,5,0,5
629,42955,2756,980,1776,0500000US17063,17063,"Grundy County, Illinois",Grundy County, Illinois,594,25,13,12,1379,167,76,91,19,0,0,0,5167,568,219,349,428,31,0,31,21,0,0,0,1129,231,51,180
630,7747,1041,466,575,0500000US17065,17065,"Hamilton County, Illinois",Hamilton County, Illinois,15,15,15,0,106,34,6,28,30,0,0,0,118,0,0,0,55,0,0,0,0,0,0,0,51,0,0,0
631,16867,2139,930,1209,0500000US17067,17067,"Hancock County, Illinois",Hancock County, Illinois,64,10,10,0,437,74,34,40,0,0,0,0,271,74,50,24,59,4,3,1,1,1,1,0,17,10,10,0
632,3719,479,212,267,0500000US17069,17069,"Hardin County, Illinois",Hardin County, Illinois,36,0,0,0,14,6,0,6,0,0,0,0,20,9,0,9,0,0,0,0,10,10,10,0,0,0,0,0
633,6386,575,253,322,0500000US17071,17071,"Henderson County, Illinois",Henderson County, Illinois,0,0,0,0,135,0,0,0,0,0,0,0,121,0,0,0,45,0,0,0,0,0,0,0,0,0,0,0
634,43534,4147,1834,2313,0500000US17073,17073,"Henry County, Illinois",Henry County, Illinois,732,265,98,167,1136,123,46,77,0,0,0,0,2821,609,309,300,229,21,0,21,43,0,0,0,1124,468,255,213
635,23980,2552,1131,1421,0500000US17075,17075,"Iroquois County, Illinois",Iroquois County, Illinois,181,19,19,0,617,57,21,36,0,0,0,0,1913,405,218,187,100,38,0,38,22,2,0,2,1144,325,183,142
636,40097,7510,3892,3618,0500000US17077,17077,"Jackson County, Illinois",Jackson County, Illinois,7769,3453,1271,2182,1839,530,287,243,116,19,0,19,2162,716,152,564,1866,493,326,167,155,75,56,19,1007,501,111,390
637,9157,1118,490,628,0500000US17079,17079,"Jasper County, Illinois",Jasper County, Illinois,15,7,1,6,195,13,9,4,0,0,0,0,60,5,4,1,10,9,1,8,3,0,0,0,17,0,0,0
638,30797,4299,1668,2631,0500000US17081,17081,"Jefferson County, Illinois",Jefferson County, Illinois,2242,668,270,398,1491,338,200,138,7,0,0,0,839,265,133,132,453,0,0,0,65,2,2,0,115,29,4,25
639,19909,1576,664,912,0500000US17083,17083,"Jersey County, Illinois",Jersey County, Illinois,27,6,6,0,557,26,21,5,0,0,0,0,287,80,0,80,47,0,0,0,16,0,0,0,21,0,0,0
640,20112,1869,703,1166,0500000US17085,17085,"Jo Daviess County, Illinois",Jo Daviess County, Illinois,93,20,7,13,318,67,46,21,7,5,0,5,643,87,47,40,127,0,0,0,69,13,3,10,59,15,15,0
641,9847,1243,439,804,0500000US17087,17087,"Johnson County, Illinois",Johnson County, Illinois,12,3,3,0,64,39,31,8,0,0,0,0,103,11,3,8,30,5,0,5,16,0,0,0,50,0,0,0
642,297938,15287,6205,9082,0500000US17089,17089,"Kane County, Illinois",Kane County, Illinois,27898,6165,2637,3528,30141,2810,1286,1524,263,32,27,5,167800,21148,9538,11610,21087,1087,520,567,2669,70,40,30,70399,9543,4328,5215
643,75358,6153,2760,3393,0500000US17091,17091,"Kankakee County, Illinois",Kankakee County, Illinois,15568,5028,2003,3025,3546,479,233,246,3,0,0,0,11316,2319,1076,1243,885,6,2,4,217,90,5,85,2863,505,273,232
644,86780,3009,1185,1824,0500000US17093,17093,"Kendall County, Illinois",Kendall County, Illinois,10013,1534,715,819,6575,210,102,108,0,0,0,0,24619,823,319,504,4257,50,33,17,178,0,0,0,6304,49,49,0
645,39458,5400,2643,2757,0500000US17095,17095,"Knox County, Illinois",Knox County, Illinois,3051,1702,851,851,1059,190,105,85,0,0,0,0,2316,334,220,114,254,38,12,26,129,31,4,27,739,136,87,49
646,415938,20080,8417,11663,0500000US17097,17097,"Lake County, Illinois",Lake County, Illinois,44296,9011,3354,5657,32300,3084,1471,1613,323,53,5,48,150183,18375,8141,10234,55114,2567,956,1611,2637,218,93,125,50701,6448,2763,3685
647,90571,11224,4895,6329,0500000US17099,17099,"LaSalle County, Illinois",LaSalle County, Illinois,1805,729,329,400,2559,493,151,342,16,0,0,0,10329,1753,779,974,887,239,28,211,110,0,0,0,2726,252,101,151
648,12584,1694,718,976,0500000US17101,17101,"Lawrence County, Illinois",Lawrence County, Illinois,328,43,0,43,415,71,7,64,0,0,0,0,70,2,1,1,11,0,0,0,28,24,11,13,23,1,0,1
649,27956,3429,1599,1830,0500000US17103,17103,"Lee County, Illinois",Lee County, Illinois,521,86,48,38,874,44,15,29,17,0,0,0,1728,154,73,81,198,0,0,0,57,4,4,0,344,91,49,42
650,30803,3512,1473,2039,0500000US17105,17105,"Livingston County, Illinois",Livingston County, Illinois,570,289,148,141,676,166,69,97,0,0,0,0,1391,401,174,227,285,0,0,0,3,0,0,0,469,26,19,7
651,23215,1906,856,1050,0500000US17107,17107,"Logan County, Illinois",Logan County, Illinois,329,252,225,27,744,141,82,59,6,0,0,0,576,206,110,96,94,19,14,5,32,0,0,0,94,24,24,0
652,24340,4981,2331,2650,0500000US17109,17109,"McDonough County, Illinois",McDonough County, Illinois,603,150,40,110,753,99,20,79,0,0,0,0,570,284,93,191,673,29,0,29,21,6,6,0,146,129,21,108
653,245129,12572,5424,7148,0500000US17111,17111,"McHenry County, Illinois",McHenry County, Illinois,4284,508,259,249,10721,778,394,384,4,0,0,0,40556,5529,2635,2894,8243,806,414,392,278,24,0,24,4655,524,280,244
654,130150,17534,8121,9413,0500000US17113,17113,"McLean County, Illinois",McLean County, Illinois,12949,4657,1717,2940,4789,477,276,201,13,0,0,0,7962,1687,768,919,8610,807,374,433,335,33,29,4,1188,185,118,67
655,77007,8278,3779,4499,0500000US17115,17115,"Macon County, Illinois",Macon County, Illinois,15555,5057,1994,3063,5073,1453,465,988,55,10,7,3,2235,498,270,228,1198,104,18,86,191,65,36,29,531,57,33,24
656,42477,5473,2149,3324,0500000US17117,17117,"Macoupin County, Illinois",Macoupin County, Illinois,372,167,129,38,704,172,82,90,0,0,0,0,546,194,88,106,178,3,0,3,141,92,24,68,152,103,75,28
657,218858,21510,9497,12013,0500000US17119,17119,"Madison County, Illinois",Madison County, Illinois,22142,7875,3514,4361,7246,1331,445,886,27,0,0,0,8735,1406,837,569,2625,265,123,142,323,109,95,14,1813,467,348,119
658,33096,5184,2166,3018,0500000US17121,17121,"Marion County, Illinois",Marion County, Illinois,1193,291,172,119,1125,210,94,116,2,0,0,0,703,252,84,168,205,75,27,48,56,8,1,7,361,55,37,18
659,10469,1116,413,703,0500000US17123,17123,"Marshall County, Illinois",Marshall County, Illinois,14,0,0,0,243,21,7,14,0,0,0,0,349,67,33,34,15,0,0,0,3,0,0,0,92,17,6,11
660,12847,1846,753,1093,0500000US17125,17125,"Mason County, Illinois",Mason County, Illinois,26,23,20,3,250,123,94,29,0,0,0,0,148,87,51,36,30,0,0,0,17,10,0,10,37,37,15,22
661,11968,1793,705,1088,0500000US17127,17127,"Massac County, Illinois",Massac County, Illinois,742,222,76,146,521,86,23,63,0,0,0,0,421,236,86,150,27,6,0,6,8,0,0,0,0,0,0,0
662,11572,884,430,454,0500000US17129,17129,"Menard County, Illinois",Menard County, Illinois,54,11,0,11,235,9,1,8,0,0,0,0,191,19,0,19,48,0,0,0,16,0,0,0,7,0,0,0
663,14519,1357,494,863,0500000US17131,17131,"Mercer County, Illinois",Mercer County, Illinois,36,23,23,0,348,121,69,52,0,0,0,0,371,92,43,49,59,0,0,0,22,8,0,8,46,22,17,5
664,32859,977,409,568,0500000US17133,17133,"Monroe County, Illinois",Monroe County, Illinois,69,1,1,0,249,0,0,0,0,0,0,0,547,0,0,0,379,83,20,63,26,0,0,0,129,0,0,0
665,24785,3694,1704,1990,0500000US17135,17135,"Montgomery County, Illinois",Montgomery County, Illinois,108,48,30,18,364,175,90,85,0,0,0,0,251,56,26,30,83,21,21,0,24,0,0,0,66,5,5,0
666,28189,3279,1308,1971,0500000US17137,17137,"Morgan County, Illinois",Morgan County, Illinois,1500,302,199,103,732,275,106,169,0,0,0,0,495,178,26,152,176,6,6,0,52,7,7,0,23,2,0,2
667,13826,1202,515,687,0500000US17139,17139,"Moultrie County, Illinois",Moultrie County, Illinois,74,35,18,17,143,34,1,33,0,0,0,0,204,11,11,0,23,0,0,0,45,0,0,0,45,0,0,0
668,42989,3714,1531,2183,0500000US17141,17141,"Ogle County, Illinois",Ogle County, Illinois,442,182,83,99,1804,366,135,231,33,0,0,0,5220,827,370,457,214,2,2,0,147,0,0,0,974,37,12,25
669,121760,13004,6076,6928,0500000US17143,17143,"Peoria County, Illinois",Peoria County, Illinois,31163,10145,4217,5928,7569,2099,871,1228,2,0,0,0,8623,2016,947,1069,7490,403,195,208,440,40,17,23,2710,905,464,441
670,17327,2922,1032,1890,0500000US17145,17145,"Perry County, Illinois",Perry County, Illinois,155,31,15,16,402,78,6,72,0,0,0,0,336,170,129,41,131,0,0,0,12,1,0,1,191,129,129,0
671,15708,847,424,423,0500000US17147,17147,"Piatt County, Illinois",Piatt County, Illinois,155,6,2,4,222,8,3,5,0,0,0,0,231,1,0,1,93,74,31,43,3,0,0,0,36,0,0,0
672,14489,2010,840,1170,0500000US17149,17149,"Pike County, Illinois",Pike County, Illinois,33,6,6,0,195,82,52,30,107,0,0,0,168,16,10,6,40,1,0,1,23,23,0,23,18,4,1,3
673,3680,827,477,350,0500000US17151,17151,"Pope County, Illinois",Pope County, Illinois,155,15,0,15,41,0,0,0,0,0,0,0,108,17,17,0,35,0,0,0,0,0,0,0,0,0,0,0
674,3407,483,201,282,0500000US17153,17153,"Pulaski County, Illinois",Pulaski County, Illinois,1632,514,160,354,174,39,26,13,0,0,0,0,116,3,3,0,6,0,0,0,7,0,0,0,13,0,0,0
675,5241,512,248,264,0500000US17155,17155,"Putnam County, Illinois",Putnam County, Illinois,29,2,2,0,65,14,4,10,0,0,0,0,324,18,14,4,58,0,0,0,0,0,0,0,70,8,6,2
676,25806,3073,1361,1712,0500000US17157,17157,"Randolph County, Illinois",Randolph County, Illinois,1301,151,118,33,393,69,34,35,2,0,0,0,695,293,218,75,116,6,6,0,57,0,0,0,293,156,107,49
677,14597,1743,727,1016,0500000US17159,17159,"Richland County, Illinois",Richland County, Illinois,90,81,21,60,276,64,25,39,0,0,0,0,264,134,70,64,102,0,0,0,28,0,0,0,148,9,9,0
678,98980,10324,4815,5509,0500000US17161,17161,"Rock Island County, Illinois",Rock Island County, Illinois,13796,4345,1928,2417,6800,1636,876,760,213,48,29,19,18028,3449,1693,1756,3267,728,378,350,609,149,44,105,4220,606,233,373
679,156812,11023,4830,6193,0500000US17163,17163,"St. Clair County, Illinois",St. Clair County, Illinois,76527,21981,9346,12635,9711,1944,998,946,51,6,0,6,10797,2657,1137,1520,3702,224,57,167,403,25,1,24,3951,1083,510,573
680,21288,3931,1915,2016,0500000US17165,17165,"Saline County, Illinois",Saline County, Illinois,434,60,30,30,871,225,119,106,57,0,0,0,391,8,1,7,104,7,0,7,78,25,0,25,81,0,0,0
681,153902,14740,6717,8023,0500000US17167,17167,"Sangamon County, Illinois",Sangamon County, Illinois,24022,9365,4098,5267,6611,1889,825,1064,149,0,0,0,4342,712,322,390,3863,492,242,250,210,3,0,3,707,125,37,88
682,6322,854,583,271,0500000US17169,17169,"Schuyler County, Illinois",Schuyler County, Illinois,337,219,219,0,81,71,71,0,0,0,0,0,56,39,39,0,10,0,0,0,2,0,0,0,3,0,0,0
683,4736,595,249,346,0500000US17171,17171,"Scott County, Illinois",Scott County, Illinois,21,0,0,0,42,0,0,0,30,0,0,0,58,6,3,3,22,0,0,0,8,0,0,0,17,3,3,0
684,20824,2023,1022,1001,0500000US17173,17173,"Shelby County, Illinois",Shelby County, Illinois,121,0,0,0,221,20,6,14,10,0,0,0,230,57,33,24,67,0,0,0,12,0,0,0,7,0,0,0
685,4968,720,261,459,0500000US17175,17175,"Stark County, Illinois",Stark County, Illinois,27,17,17,0,104,9,0,9,0,0,0,0,100,10,7,3,53,0,0,0,0,0,0,0,11,0,0,0
686,35948,3995,1565,2430,0500000US17177,17177,"Stephenson County, Illinois",Stephenson County, Illinois,4142,1599,732,867,1925,371,226,145,0,0,0,0,1842,433,314,119,367,111,99,12,76,0,0,0,219,49,46,3
687,122238,9986,4186,5800,0500000US17179,17179,"Tazewell County, Illinois",Tazewell County, Illinois,909,188,127,61,2295,458,314,144,28,0,0,0,3047,377,211,166,1470,173,77,96,135,50,0,50,421,24,4,20
688,15077,2555,1235,1320,0500000US17181,17181,"Union County, Illinois",Union County, Illinois,205,159,96,63,646,120,93,27,32,0,0,0,886,269,169,100,53,28,3,25,12,2,2,0,126,1,1,0
689,58520,8328,4004,4324,0500000US17183,17183,"Vermilion County, Illinois",Vermilion County, Illinois,9485,4347,2023,2324,1808,557,248,309,18,7,0,7,3435,732,436,296,746,85,53,32,96,40,0,40,359,27,18,9
690,10607,1310,549,761,0500000US17185,17185,"Wabash County, Illinois",Wabash County, Illinois,8,6,5,1,229,8,4,4,0,0,0,0,255,29,29,0,204,0,0,0,5,0,0,0,32,0,0,0
691,13288,1573,672,901,0500000US17187,17187,"Warren County, Illinois",Warren County, Illinois,539,3,3,0,277,0,0,0,0,0,0,0,1528,221,129,92,164,20,6,14,177,110,100,10,666,6,6,0
692,13263,894,383,511,0500000US17189,17189,"Washington County, Illinois",Washington County, Illinois,48,11,2,9,129,33,2,31,2,0,0,0,200,78,51,27,102,0,0,0,16,15,10,5,84,78,51,27
693,15622,1866,833,1033,0500000US17191,17191,"Wayne County, Illinois",Wayne County, Illinois,144,115,40,75,162,40,31,9,0,0,0,0,256,105,33,72,41,13,0,13,20,8,8,0,108,62,33,29
694,12833,1901,831,1070,0500000US17193,17193,"White County, Illinois",White County, Illinois,27,19,14,5,167,36,24,12,3,0,0,0,177,53,14,39,29,7,0,7,31,5,0,5,32,0,0,0
695,45735,3778,1651,2127,0500000US17195,17195,"Whiteside County, Illinois",Whiteside County, Illinois,594,92,43,49,1957,907,383,524,85,0,0,0,6728,1070,467,603,340,12,12,0,93,33,29,4,558,10,7,3
696,429310,20044,8530,11514,0500000US17197,17197,"Will County, Illinois",Will County, Illinois,74286,10822,4416,6406,32008,2990,1275,1715,529,28,28,0,120796,12299,5255,7044,38139,1668,834,834,2544,205,62,143,40722,3790,1696,2094
697,58248,7065,2920,4145,0500000US17199,17199,"Williamson County, Illinois",Williamson County, Illinois,2089,895,392,503,1982,628,330,298,30,30,30,0,1637,323,232,91,760,139,35,104,61,10,0,10,755,17,15,2
698,190245,19061,8312,10749,0500000US17201,17201,"Winnebago County, Illinois",Winnebago County, Illinois,36668,13946,6287,7659,13055,3154,1580,1574,35,18,0,18,36729,8136,3751,4385,7668,1011,611,400,416,103,98,5,6696,1262,660,602
699,35804,1962,903,1059,0500000US17203,17203,"Woodford County, Illinois",Woodford County, Illinois,183,44,37,7,525,130,73,57,0,0,0,0,716,23,13,10,190,29,0,29,20,5,4,1,170,0,0,0
700,32558,4842,2108,2734,0500000US18001,18001,"Adams County, Indiana",Adams County, Indiana,324,252,132,120,480,224,95,129,0,0,0,0,1622,565,258,307,91,19,0,19,34,0,0,0,673,254,121,133
701,270206,22511,9611,12900,0500000US18003,18003,"Allen County, Indiana",Allen County, Indiana,41767,12191,5341,6850,16185,3736,1975,1761,139,14,0,14,28372,6244,2922,3322,15575,2887,1230,1657,739,226,73,153,8318,1365,590,775
702,66261,7280,3076,4204,0500000US18005,18005,"Bartholomew County, Indiana",Bartholomew County, Indiana,1422,168,48,120,2857,458,232,226,0,0,0,0,6003,1934,1176,758,6579,550,338,212,104,29,0,29,2524,1208,741,467
703,7894,1129,383,746,0500000US18007,18007,"Benton County, Indiana",Benton County, Indiana,39,4,4,0,178,30,28,2,13,0,0,0,465,164,98,66,7,0,0,0,2,0,0,0,20,6,6,0
704,11182,1834,982,852,0500000US18009,18009,"Blackford County, Indiana",Blackford County, Indiana,49,49,0,49,229,43,31,12,0,0,0,0,207,0,0,0,39,19,15,4,29,20,20,0,0,0,0,0
705,59448,3754,1550,2204,0500000US18011,18011,"Boone County, Indiana",Boone County, Indiana,1093,195,67,128,1740,181,35,146,0,0,0,0,2068,45,19,26,2122,141,94,47,62,0,0,0,289,30,17,13
706,14194,1163,436,727,0500000US18013,18013,"Brown County, Indiana",Brown County, Indiana,175,96,96,0,254,69,10,59,0,0,0,0,272,64,8,56,41,0,0,0,0,0,0,0,38,7,3,4
707,18619,1319,505,814,0500000US18015,18015,"Carroll County, Indiana",Carroll County, Indiana,94,1,0,1,271,46,26,20,0,0,0,0,850,219,167,52,51,0,0,0,22,0,0,0,419,76,69,7
708,28894,3171,1541,1630,0500000US18017,18017,"Cass County, Indiana",Cass County, Indiana,290,145,100,45,1281,366,202,164,18,0,0,0,5873,1054,471,583,608,39,0,39,131,3,0,3,3605,792,336,456
709,95415,7902,3452,4450,0500000US18019,18019,"Clark County, Indiana",Clark County, Indiana,7078,1529,738,791,5157,968,584,384,16,0,0,0,6408,1087,457,630,1090,55,38,17,144,0,0,0,1168,140,127,13
710,24398,2816,1287,1529,0500000US18021,18021,"Clay County, Indiana",Clay County, Indiana,121,24,11,13,512,65,36,29,6,0,0,0,345,42,1,41,66,0,0,0,41,5,0,5,33,0,0,0
711,25730,2500,1093,1407,0500000US18023,18023,"Clinton County, Indiana",Clinton County, Indiana,136,43,38,5,750,123,29,94,23,5,0,5,5035,1060,494,566,78,18,9,9,1,0,0,0,1990,141,60,81
712,9972,1765,687,1078,0500000US18025,18025,"Crawford County, Indiana",Crawford County, Indiana,36,25,25,0,235,133,53,80,0,0,0,0,158,109,72,37,0,0,0,0,20,13,0,13,27,0,0,0
713,29286,3118,1559,1559,0500000US18027,18027,"Daviess County, Indiana",Daviess County, Indiana,517,277,139,138,927,139,36,103,8,8,8,0,1769,302,114,188,69,28,12,16,0,0,0,0,808,56,0,56
714,47094,3847,1859,1988,0500000US18029,18029,"Dearborn County, Indiana",Dearborn County, Indiana,320,95,21,74,513,142,52,90,34,0,0,0,660,55,14,41,275,0,0,0,25,0,0,0,76,24,0,24
715,24712,2638,898,1740,0500000US18031,18031,"Decatur County, Indiana",Decatur County, Indiana,0,0,0,0,405,14,14,0,0,0,0,0,550,73,32,41,492,20,20,0,42,0,0,0,103,15,15,0
716,40620,4303,1516,2787,0500000US18033,18033,"DeKalb County, Indiana",DeKalb County, Indiana,151,96,90,6,727,105,59,46,0,0,0,0,1240,180,61,119,196,45,12,33,19,8,7,1,183,32,19,13
717,93216,17970,7988,9982,0500000US18035,18035,"Delaware County, Indiana",Delaware County, Indiana,7001,2612,1302,1310,3378,1484,644,840,105,1,0,1,2456,760,311,449,1546,456,321,135,84,9,1,8,461,157,35,122
718,37348,3030,1421,1609,0500000US18037,18037,"Dubois County, Indiana",Dubois County, Indiana,488,86,84,2,866,149,72,77,0,0,0,0,3341,593,227,366,308,0,0,0,113,55,55,0,933,151,100,51
719,149736,12702,5771,6931,0500000US18039,18039,"Elkhart County, Indiana",Elkhart County, Indiana,10447,3725,1713,2012,9945,2100,879,1221,117,23,23,0,32999,5932,2816,3116,1865,70,0,70,565,29,14,15,6631,982,456,526
720,21338,3589,1386,2203,0500000US18041,18041,"Fayette County, Indiana",Fayette County, Indiana,584,415,177,238,426,24,7,17,0,0,0,0,296,96,49,47,10,0,0,0,44,0,0,0,82,7,0,7
721,66784,4481,1766,2715,0500000US18043,18043,"Floyd County, Indiana",Floyd County, Indiana,3858,1302,780,522,2618,611,205,406,11,0,0,0,2606,954,292,662,854,52,19,33,196,20,6,14,264,9,0,9
722,15456,1667,799,868,0500000US18045,18045,"Fountain County, Indiana",Fountain County, Indiana,60,34,34,0,222,63,14,49,0,0,0,0,422,70,26,44,86,51,21,30,29,18,2,16,20,0,0,0
723,21899,1686,726,960,0500000US18047,18047,"Franklin County, Indiana",Franklin County, Indiana,32,0,0,0,471,103,0,103,0,0,0,0,267,21,13,8,87,0,0,0,2,0,0,0,47,0,0,0
724,18012,2485,1218,1267,0500000US18049,18049,"Fulton County, Indiana",Fulton County, Indiana,121,43,1,42,501,112,110,2,7,0,0,0,1057,222,95,127,43,0,0,0,32,1,1,0,559,65,25,40
725,30585,2720,1076,1644,0500000US18051,18051,"Gibson County, Indiana",Gibson County, Indiana,693,59,57,2,897,165,135,30,0,0,0,0,538,96,44,52,105,6,6,0,6,0,0,0,231,30,26,4
726,51049,7552,3301,4251,0500000US18053,18053,"Grant County, Indiana",Grant County, Indiana,4521,2038,861,1177,2034,704,333,371,0,0,0,0,2733,977,475,502,511,93,44,49,151,14,0,14,597,304,159,145
727,30610,4023,1735,2288,0500000US18055,18055,"Greene County, Indiana",Greene County, Indiana,61,29,5,24,627,79,26,53,20,0,0,0,531,158,52,106,37,0,0,0,4,0,0,0,86,28,16,12
728,272737,9778,4045,5733,0500000US18057,18057,"Hamilton County, Indiana",Hamilton County, Indiana,12702,1085,627,458,9935,1120,490,630,102,0,0,0,13587,1733,792,941,19978,742,283,459,498,22,22,0,2595,347,98,249
729,69689,4172,1713,2459,0500000US18059,18059,"Hancock County, Indiana",Hancock County, Indiana,1977,229,149,80,1646,27,0,27,0,0,0,0,1916,15,0,15,701,18,10,8,0,0,0,0,461,0,0,0
730,37713,3370,1522,1848,0500000US18061,18061,"Harrison County, Indiana",Harrison County, Indiana,191,4,4,0,546,21,6,15,0,0,0,0,803,176,91,85,214,13,1,12,47,0,0,0,438,151,90,61
731,136310,5092,2386,2706,0500000US18063,18063,"Hendricks County, Indiana",Hendricks County, Indiana,11212,1511,762,749,4776,603,176,427,17,0,0,0,6783,503,236,267,4869,969,399,570,243,0,0,0,1951,132,0,132
732,42401,5561,2395,3166,0500000US18065,18065,"Henry County, Indiana",Henry County, Indiana,697,225,204,21,610,119,89,30,7,0,0,0,672,218,131,87,131,62,0,62,34,2,2,0,263,55,2,53
733,68604,7010,3129,3881,0500000US18067,18067,"Howard County, Indiana",Howard County, Indiana,6382,1801,905,896,2102,317,133,184,18,6,0,6,2866,540,209,331,1113,30,18,12,443,75,29,46,643,69,69,0
734,33013,3367,1339,2028,0500000US18069,18069,"Huntington County, Indiana",Huntington County, Indiana,231,52,25,27,490,77,23,54,57,38,38,0,880,290,163,127,228,92,50,42,100,0,0,0,402,238,140,98
735,37313,4445,1666,2779,0500000US18071,18071,"Jackson County, Indiana",Jackson County, Indiana,547,90,6,84,705,109,27,82,19,0,0,0,3201,761,415,346,1074,457,196,261,112,75,45,30,2078,411,180,231
736,29328,2241,870,1371,0500000US18073,18073,"Jasper County, Indiana",Jasper County, Indiana,187,1,0,1,1252,66,0,66,0,0,0,0,2031,326,109,217,63,0,0,0,5,0,0,0,897,242,90,152
737,19348,2644,1095,1549,0500000US18075,18075,"Jay County, Indiana",Jay County, Indiana,26,23,10,13,207,45,21,24,0,0,0,0,643,228,128,100,95,3,0,3,101,0,0,0,234,175,113,62
738,27631,3537,1200,2337,0500000US18077,18077,"Jefferson County, Indiana",Jefferson County, Indiana,504,130,58,72,644,351,96,255,0,0,0,0,818,459,207,252,154,12,0,12,59,0,0,0,202,0,0,0
739,25508,2453,1176,1277,0500000US18079,18079,"Jennings County, Indiana",Jennings County, Indiana,248,3,0,3,472,142,81,61,0,0,0,0,722,317,136,181,14,0,0,0,105,4,3,1,207,48,0,48
740,135246,9820,4586,5234,0500000US18081,18081,"Johnson County, Indiana",Johnson County, Indiana,3757,556,223,333,3386,490,179,311,47,21,0,21,5668,1009,350,659,5848,291,222,69,381,0,0,0,1232,5,5,0
741,31968,4495,1844,2651,0500000US18083,18083,"Knox County, Indiana",Knox County, Indiana,666,152,46,106,791,157,78,79,19,0,0,0,789,514,147,367,305,170,114,56,16,0,0,0,365,276,66,210
742,67801,5353,2131,3222,0500000US18085,18085,"Kosciusko County, Indiana",Kosciusko County, Indiana,429,75,36,39,2525,303,74,229,30,0,0,0,6231,1349,617,732,1168,192,166,26,261,199,75,124,1076,302,137,165
743,36718,2186,941,1245,0500000US18087,18087,"LaGrange County, Indiana",LaGrange County, Indiana,59,2,0,2,800,41,14,27,0,0,0,0,1618,98,90,8,34,14,0,14,7,0,0,0,154,0,0,0
744,256729,21759,9444,12315,0500000US18089,18089,"Lake County, Indiana",Lake County, Indiana,113050,32947,13793,19154,23063,3869,1902,1967,145,0,0,0,93064,16733,7514,9219,6678,795,343,452,1191,214,59,155,42341,9434,3949,5485
745,81999,10465,4518,5947,0500000US18091,18091,"LaPorte County, Indiana",LaPorte County, Indiana,9026,2544,1013,1531,4523,1725,844,881,13,13,13,0,6767,1255,635,620,712,190,60,130,299,39,33,6,2255,399,224,175
746,42519,4434,1775,2659,0500000US18093,18093,"Lawrence County, Indiana",Lawrence County, Indiana,176,74,9,65,885,175,104,71,7,7,0,7,766,248,161,87,242,0,0,0,88,54,39,15,417,146,112,34
747,104917,13460,5891,7569,0500000US18095,18095,"Madison County, Indiana",Madison County, Indiana,8878,3104,1603,1501,3767,1038,455,583,1,1,1,0,5023,1259,526,733,605,92,0,92,206,44,23,21,1420,316,137,179
748,508117,56265,25458,30807,0500000US18097,18097,"Marion County, Indiana",Marion County, Indiana,264661,65107,27569,37538,40616,6223,2534,3689,202,17,17,0,99836,22909,10277,12632,33779,5958,3232,2726,1908,406,163,243,36537,8735,4293,4442
749,39722,4598,1793,2805,0500000US18099,18099,"Marshall County, Indiana",Marshall County, Indiana,251,95,66,29,1027,101,46,55,0,0,0,0,4680,941,372,569,242,7,7,0,119,0,0,0,833,14,14,0
750,9401,1094,566,528,0500000US18101,18101,"Martin County, Indiana",Martin County, Indiana,7,7,4,3,129,82,42,40,0,0,0,0,157,0,0,0,28,0,0,0,106,0,0,0,5,0,0,0
751,30151,4408,2045,2363,0500000US18103,18103,"Miami County, Indiana",Miami County, Indiana,957,380,246,134,927,111,50,61,0,0,0,0,948,300,122,178,202,6,0,6,214,0,0,0,371,31,31,0
752,110783,22580,11491,11089,0500000US18105,18105,"Monroe County, Indiana",Monroe County, Indiana,4297,1559,669,890,5362,1721,731,990,8,8,7,1,4251,887,468,419,7597,3025,1823,1202,359,40,40,0,478,122,91,31
753,33724,3144,1297,1847,0500000US18107,18107,"Montgomery County, Indiana",Montgomery County, Indiana,307,189,108,81,1007,260,67,193,14,14,0,14,1849,888,380,508,233,4,0,4,38,0,0,0,342,222,91,131
754,65729,5465,2420,3045,0500000US18109,18109,"Morgan County, Indiana",Morgan County, Indiana,155,3,3,0,1293,294,114,180,0,0,0,0,1153,231,113,118,585,146,32,114,14,0,0,0,324,42,41,1
755,12435,1264,514,750,0500000US18111,18111,"Newton County, Indiana",Newton County, Indiana,173,31,24,7,231,79,18,61,0,0,0,0,942,271,108,163,0,0,0,0,19,9,0,9,368,118,74,44
756,40461,3008,1380,1628,0500000US18113,18113,"Noble County, Indiana",Noble County, Indiana,233,207,135,72,1352,230,104,126,33,0,0,0,4918,321,125,196,325,1,1,0,26,1,0,1,356,90,38,52
757,5509,480,152,328,0500000US18115,18115,"Ohio County, Indiana",Ohio County, Indiana,31,10,10,0,127,45,2,43,0,0,0,0,80,0,0,0,29,8,8,0,5,0,0,0,36,0,0,0
758,18192,2532,957,1575,0500000US18117,18117,"Orange County, Indiana",Orange County, Indiana,462,17,10,7,285,17,16,1,0,0,0,0,141,2,2,0,100,7,7,0,16,0,0,0,36,2,2,0
759,19737,2895,1294,1601,0500000US18119,18119,"Owen County, Indiana",Owen County, Indiana,58,0,0,0,489,41,34,7,0,0,0,0,269,46,12,34,101,3,3,0,103,0,0,0,0,0,0,0
760,14778,2144,846,1298,0500000US18121,18121,"Parke County, Indiana",Parke County, Indiana,139,0,0,0,392,6,2,4,0,0,0,0,196,9,0,9,0,0,0,0,33,4,4,0,47,12,6,6
761,16666,1983,863,1120,0500000US18123,18123,"Perry County, Indiana",Perry County, Indiana,167,18,0,18,346,129,34,95,0,0,0,0,230,61,0,61,113,0,0,0,30,14,14,0,46,8,8,0
762,11659,1108,530,578,0500000US18125,18125,"Pike County, Indiana",Pike County, Indiana,53,39,22,17,119,34,0,34,0,0,0,0,176,0,0,0,69,69,18,51,0,0,0,0,176,0,0,0
763,136190,11029,4452,6577,0500000US18127,18127,"Porter County, Indiana",Porter County, Indiana,6394,1291,553,738,5686,796,555,241,78,30,0,30,16901,2233,1099,1134,2149,383,278,105,315,121,36,85,2481,507,313,194
764,24098,2060,846,1214,0500000US18129,18129,"Posey County, Indiana",Posey County, Indiana,434,190,123,67,286,7,0,7,0,0,0,0,314,60,34,26,74,0,0,0,14,0,0,0,246,92,61,31
765,11516,1132,501,631,0500000US18131,18131,"Pulaski County, Indiana",Pulaski County, Indiana,12,12,12,0,350,88,0,88,39,0,0,0,381,9,4,5,58,53,28,25,31,0,0,0,178,0,0,0
766,30383,2946,1268,1678,0500000US18133,18133,"Putnam County, Indiana",Putnam County, Indiana,139,2,2,0,537,33,26,7,0,0,0,0,403,54,29,25,584,0,0,0,65,0,0,0,36,0,0,0
767,22372,2648,1108,1540,0500000US18135,18135,"Randolph County, Indiana",Randolph County, Indiana,105,0,0,0,563,184,126,58,0,0,0,0,888,236,111,125,92,0,0,0,18,0,0,0,481,16,8,8
768,26630,3200,1416,1784,0500000US18137,18137,"Ripley County, Indiana",Ripley County, Indiana,73,25,7,18,358,7,1,6,0,0,0,0,526,49,16,33,270,27,27,0,36,6,6,0,138,13,2,11
769,15656,1992,828,1164,0500000US18139,18139,"Rush County, Indiana",Rush County, Indiana,312,35,35,0,95,11,11,0,0,0,0,0,270,46,20,26,17,0,0,0,3,0,0,0,38,21,2,19
770,185219,19087,8346,10741,0500000US18141,18141,"St. Joseph County, Indiana",St. Joseph County, Indiana,33702,10316,4283,6033,13264,3291,1898,1393,138,0,0,0,22893,5102,2377,2725,6332,853,411,442,1208,181,137,44,7137,2004,1003,1001
771,21670,3342,1248,2094,0500000US18143,18143,"Scott County, Indiana",Scott County, Indiana,7,5,1,4,367,195,54,141,0,0,0,0,574,56,27,29,66,0,0,0,161,0,0,0,170,27,27,0
772,40208,3707,1586,2121,0500000US18145,18145,"Shelby County, Indiana",Shelby County, Indiana,341,83,4,79,884,93,47,46,7,0,0,0,1922,784,316,468,217,0,0,0,25,8,0,8,987,522,276,246
773,18999,1516,523,993,0500000US18147,18147,"Spencer County, Indiana",Spencer County, Indiana,108,3,1,2,309,57,21,36,0,0,0,0,604,40,9,31,70,20,11,9,17,0,0,0,120,0,0,0
774,21413,3813,1494,2319,0500000US18149,18149,"Starke County, Indiana",Starke County, Indiana,164,4,2,2,382,43,16,27,0,0,0,0,902,135,80,55,58,2,0,2,70,55,55,0,57,41,19,22
775,31009,3123,1409,1714,0500000US18151,18151,"Steuben County, Indiana",Steuben County, Indiana,37,5,3,2,874,83,30,53,0,0,0,0,1209,45,17,28,174,11,11,0,14,9,6,3,147,7,0,7
776,17304,2057,768,1289,0500000US18153,18153,"Sullivan County, Indiana",Sullivan County, Indiana,151,73,0,73,490,97,66,31,6,6,0,6,302,28,6,22,157,0,0,0,30,0,0,0,115,6,6,0
777,10132,2394,1170,1224,0500000US18155,18155,"Switzerland County, Indiana",Switzerland County, Indiana,45,0,0,0,164,26,26,0,82,0,0,0,206,0,0,0,73,0,0,0,0,0,0,0,45,0,0,0
778,133926,20631,10638,9993,0500000US18157,18157,"Tippecanoe County, Indiana",Tippecanoe County, Indiana,10059,3971,1823,2148,4701,975,492,483,63,0,0,0,15330,3168,1861,1307,12180,4352,2796,1556,429,95,85,10,5326,1153,748,405
779,14052,1176,458,718,0500000US18159,18159,"Tipton County, Indiana",Tipton County, Indiana,2,1,1,0,322,115,81,34,0,0,0,0,458,109,15,94,80,0,0,0,3,0,0,0,157,81,15,66
780,6590,370,136,234,0500000US18161,18161,"Union County, Indiana",Union County, Indiana,15,0,0,0,66,6,0,6,0,0,0,0,155,14,8,6,132,20,20,0,0,0,0,0,6,0,0,0
781,145238,19262,8010,11252,0500000US18163,18163,"Vanderburgh County, Indiana",Vanderburgh County, Indiana,16728,5556,2243,3313,5449,1439,699,740,353,36,0,36,4764,1337,707,630,2318,271,129,142,105,28,2,26,1869,553,278,275
782,14682,2067,913,1154,0500000US18165,18165,"Vermillion County, Indiana",Vermillion County, Indiana,102,102,102,0,174,15,2,13,8,0,0,0,200,20,15,5,44,0,0,0,28,0,0,0,67,3,3,0
783,86185,15051,6807,8244,0500000US18167,18167,"Vigo County, Indiana",Vigo County, Indiana,5837,1894,792,1102,2880,886,533,353,56,0,0,0,2188,541,282,259,1932,337,215,122,26,9,0,9,729,202,160,42
784,27773,3118,1282,1836,0500000US18169,18169,"Wabash County, Indiana",Wabash County, Indiana,166,44,35,9,291,66,59,7,0,0,0,0,681,108,35,73,162,0,0,0,268,57,28,29,352,7,0,7
785,7738,713,298,415,0500000US18171,18171,"Warren County, Indiana",Warren County, Indiana,51,43,38,5,129,9,8,1,0,0,0,0,165,103,42,61,19,7,2,5,0,0,0,0,19,0,0,0
786,56271,3128,1354,1774,0500000US18173,18173,"Warrick County, Indiana",Warrick County, Indiana,1060,77,7,70,997,96,11,85,4,0,0,0,1178,303,145,158,1768,76,29,47,54,0,0,0,714,277,119,158
787,26599,3607,1676,1931,0500000US18175,18175,"Washington County, Indiana",Washington County, Indiana,0,0,0,0,437,137,65,72,0,0,0,0,363,100,33,67,96,2,2,0,10,0,0,0,59,0,0,0
788,56000,8395,3426,4969,0500000US18177,18177,"Wayne County, Indiana",Wayne County, Indiana,2959,952,590,362,1914,458,271,187,1,0,0,0,1878,470,62,408,678,201,82,119,225,35,9,26,587,301,116,185
789,25641,2102,832,1270,0500000US18179,18179,"Wells County, Indiana",Wells County, Indiana,195,0,0,0,788,0,0,0,0,0,0,0,842,79,14,65,107,58,0,58,54,5,2,3,208,0,0,0
790,21223,1700,669,1031,0500000US18181,18181,"White County, Indiana",White County, Indiana,122,0,0,0,374,123,38,85,8,0,0,0,2065,292,77,215,79,11,0,11,141,119,71,48,1449,261,69,192
791,31584,2951,1358,1593,0500000US18183,18183,"Whitley County, Indiana",Whitley County, Indiana,74,20,18,2,869,129,76,53,0,0,0,0,720,62,37,25,146,11,2,9,65,35,24,11,41,0,0,0
792,6570,708,247,461,0500000US19001,19001,"Adair County, Iowa",Adair County, Iowa,33,5,0,5,103,21,18,3,0,0,0,0,143,16,8,8,55,16,16,0,0,0,0,0,22,0,0,0
793,3424,438,177,261,0500000US19003,19003,"Adams County, Iowa",Adams County, Iowa,4,1,0,1,49,2,2,0,0,0,0,0,47,26,4,22,23,0,0,0,8,8,0,8,29,20,2,18
794,12105,1122,501,621,0500000US19005,19005,"Allamakee County, Iowa",Allamakee County, Iowa,163,0,0,0,178,0,0,0,0,0,0,0,935,415,144,271,69,0,0,0,151,0,0,0,56,39,4,35
795,11693,2279,1200,1079,0500000US19007,19007,"Appanoose County, Iowa",Appanoose County, Iowa,73,6,3,3,235,76,45,31,0,0,0,0,258,62,29,33,35,0,0,0,49,0,0,0,15,0,0,0
796,5185,522,173,349,0500000US19009,19009,"Audubon County, Iowa",Audubon County, Iowa,0,0,0,0,160,67,67,0,0,0,0,0,44,21,11,10,2,0,0,0,0,0,0,0,19,11,1,10
797,24017,2128,765,1363,0500000US19011,19011,"Benton County, Iowa",Benton County, Iowa,85,32,21,11,464,32,11,21,0,0,0,0,391,18,10,8,100,0,0,0,40,10,10,0,185,0,0,0
798,101764,13366,5596,7770,0500000US19013,19013,"Black Hawk County, Iowa",Black Hawk County, Iowa,12306,3839,1645,2194,3639,738,381,357,367,118,37,81,5751,1456,765,691,3428,199,130,69,523,98,2,96,1398,326,69,257
799,24511,1709,811,898,0500000US19015,19015,"Boone County, Iowa",Boone County, Iowa,278,0,0,0,367,69,44,25,67,0,0,0,703,95,32,63,67,0,0,0,131,0,0,0,174,28,22,6
800,22447,1518,682,836,0500000US19017,19017,"Bremer County, Iowa",Bremer County, Iowa,128,75,16,59,339,71,44,27,0,0,0,0,335,0,0,0,249,5,0,5,51,0,0,0,73,0,0,0
801,20067,1479,647,832,0500000US19019,19019,"Buchanan County, Iowa",Buchanan County, Iowa,16,7,6,1,452,34,7,27,2,0,0,0,338,26,16,10,73,0,0,0,44,0,0,0,3,0,0,0
802,10774,1026,529,497,0500000US19021,19021,"Buena Vista County, Iowa",Buena Vista County, Iowa,382,3,3,0,838,106,73,33,332,14,10,4,5055,709,269,440,2079,221,66,155,5,4,0,4,1456,418,146,272
803,13732,1498,714,784,0500000US19023,19023,"Butler County, Iowa",Butler County, Iowa,116,4,4,0,137,19,11,8,12,0,0,0,210,14,14,0,82,38,38,0,25,14,12,2,29,0,0,0
804,8468,948,363,585,0500000US19025,19025,"Calhoun County, Iowa",Calhoun County, Iowa,70,7,0,7,162,16,14,2,0,0,0,0,181,57,46,11,36,5,5,0,18,0,0,0,66,2,0,2
805,18602,1376,651,725,0500000US19027,19027,"Carroll County, Iowa",Carroll County, Iowa,102,0,0,0,537,10,0,10,0,0,0,0,524,84,74,10,134,0,0,0,84,0,0,0,236,54,54,0
806,12097,1396,602,794,0500000US19029,19029,"Cass County, Iowa",Cass County, Iowa,73,0,0,0,142,0,0,0,17,0,0,0,376,12,4,8,36,6,0,6,36,20,0,20,92,0,0,0
807,17232,1197,527,670,0500000US19031,19031,"Cedar County, Iowa",Cedar County, Iowa,148,20,20,0,177,1,0,1,0,0,0,0,394,50,0,50,117,44,29,15,41,14,0,14,16,6,6,0
808,37667,3194,1288,1906,0500000US19033,19033,"Cerro Gordo County, Iowa",Cerro Gordo County, Iowa,831,349,169,180,845,79,42,37,91,8,8,0,2124,355,124,231,473,1,0,1,151,78,0,78,273,50,0,50
809,9905,1074,464,610,0500000US19035,19035,"Cherokee County, Iowa",Cherokee County, Iowa,341,98,41,57,316,96,20,76,0,0,0,0,74,3,0,3,125,0,0,0,0,0,0,0,4,0,0,0
810,11198,811,376,435,0500000US19037,19037,"Chickasaw County, Iowa",Chickasaw County, Iowa,54,14,14,0,126,44,18,26,2,2,2,0,338,42,27,15,12,10,0,10,16,0,0,0,53,0,0,0
811,7497,1130,529,601,0500000US19039,19039,"Clarke County, Iowa",Clarke County, Iowa,7,0,0,0,247,92,85,7,0,0,0,0,1358,355,139,216,5,1,0,1,25,9,9,0,41,0,0,0
812,14739,1448,565,883,0500000US19041,19041,"Clay County, Iowa",Clay County, Iowa,16,3,0,3,416,78,14,64,0,0,0,0,591,142,38,104,105,0,0,0,13,0,0,0,125,3,3,0
813,16522,1851,891,960,0500000US19043,19043,"Clayton County, Iowa",Clayton County, Iowa,128,84,84,0,157,20,10,10,0,0,0,0,352,161,89,72,74,4,0,4,42,3,3,0,61,0,0,0
814,41452,4853,2015,2838,0500000US19045,19045,"Clinton County, Iowa",Clinton County, Iowa,1322,836,389,447,1179,119,26,93,3,0,0,0,1479,448,289,159,303,0,0,0,118,16,0,16,76,19,0,19
815,10858,1574,774,800,0500000US19047,19047,"Crawford County, Iowa",Crawford County, Iowa,526,276,123,153,694,354,41,313,23,1,0,1,4844,1102,273,829,387,106,98,8,95,95,58,37,1421,97,21,76
816,75717,3259,1622,1637,0500000US19049,19049,"Dallas County, Iowa",Dallas County, Iowa,1698,119,75,44,3243,389,130,259,104,0,0,0,5555,901,501,400,4160,154,83,71,91,1,0,1,765,42,31,11
817,8561,919,381,538,0500000US19051,19051,"Davis County, Iowa",Davis County, Iowa,0,0,0,0,116,1,1,0,0,0,0,0,137,1,0,1,51,0,0,0,38,0,0,0,19,1,0,1
818,6694,1005,502,503,0500000US19053,19053,"Decatur County, Iowa",Decatur County, Iowa,42,9,8,1,230,87,74,13,14,2,2,0,175,21,19,2,56,12,6,6,0,0,0,0,23,11,10,1
819,16241,1276,557,719,0500000US19055,19055,"Delaware County, Iowa",Delaware County, Iowa,40,28,22,6,289,45,21,24,0,0,0,0,257,109,59,50,85,0,0,0,16,11,0,11,109,3,3,0
820,33410,3939,1596,2343,0500000US19057,19057,"Des Moines County, Iowa",Des Moines County, Iowa,2260,1304,457,847,1102,185,17,168,2,0,0,0,1296,272,133,139,363,30,2,28,44,0,0,0,131,100,35,65
821,16213,1146,469,677,0500000US19059,19059,"Dickinson County, Iowa",Dickinson County, Iowa,25,23,14,9,273,7,7,0,0,0,0,0,369,39,7,32,169,57,38,19,30,9,5,4,58,0,0,0
822,84871,6923,2377,4546,0500000US19061,19061,"Dubuque County, Iowa",Dubuque County, Iowa,2715,1067,595,472,2266,312,104,208,577,364,136,228,2244,494,202,292,1103,120,37,83,213,35,35,0,405,161,62,99
823,7382,750,295,455,0500000US19063,19063,"Emmet County, Iowa",Emmet County, Iowa,63,0,0,0,162,20,15,5,0,0,0,0,852,72,22,50,22,0,0,0,0,0,0,0,152,3,3,0
824,17767,2040,917,1123,0500000US19065,19065,"Fayette County, Iowa",Fayette County, Iowa,242,110,103,7,523,118,67,51,1,1,1,0,425,18,6,12,58,0,0,0,26,1,0,1,25,7,0,7
825,13973,1577,623,954,0500000US19067,19067,"Floyd County, Iowa",Floyd County, Iowa,228,26,8,18,340,143,48,95,107,0,0,0,574,130,43,87,237,19,0,19,87,60,0,60,47,20,6,14
826,8378,858,321,537,0500000US19069,19069,"Franklin County, Iowa",Franklin County, Iowa,133,17,17,0,247,131,109,22,0,0,0,0,1305,692,310,382,0,0,0,0,5,0,0,0,18,0,0,0
827,6364,522,189,333,0500000US19071,19071,"Fremont County, Iowa",Fremont County, Iowa,53,2,0,2,123,8,7,1,0,0,0,0,200,14,1,13,0,0,0,0,18,2,0,2,85,0,0,0
828,8289,760,284,476,0500000US19073,19073,"Greene County, Iowa",Greene County, Iowa,29,0,0,0,218,25,5,20,0,0,0,0,264,9,0,9,47,0,0,0,13,0,0,0,72,9,0,9
829,11686,607,226,381,0500000US19075,19075,"Grundy County, Iowa",Grundy County, Iowa,85,0,0,0,136,10,10,0,0,0,0,0,164,5,0,5,36,0,0,0,9,0,0,0,0,0,0,0
830,10030,887,412,475,0500000US19077,19077,"Guthrie County, Iowa",Guthrie County, Iowa,22,0,0,0,236,22,20,2,0,0,0,0,295,54,16,38,27,0,0,0,14,3,3,0,103,38,16,22
831,13071,832,323,509,0500000US19079,19079,"Hamilton County, Iowa",Hamilton County, Iowa,182,134,39,95,267,21,15,6,40,0,0,0,922,60,36,24,405,61,53,8,26,3,3,0,93,41,24,17
832,9697,901,444,457,0500000US19081,19081,"Hancock County, Iowa",Hancock County, Iowa,142,126,34,92,140,31,5,26,0,0,0,0,499,94,30,64,41,0,0,0,30,11,9,2,68,13,2,11
833,14858,1454,653,801,0500000US19083,19083,"Hardin County, Iowa",Hardin County, Iowa,120,0,0,0,336,9,3,6,19,0,0,0,689,79,23,56,64,0,0,0,94,10,0,10,105,2,2,0
834,13221,1171,405,766,0500000US19085,19085,"Harrison County, Iowa",Harrison County, Iowa,34,0,0,0,226,14,14,0,19,0,0,0,259,8,0,8,37,0,0,0,34,11,7,4,16,0,0,0
835,16297,1441,604,837,0500000US19087,19087,"Henry County, Iowa",Henry County, Iowa,189,60,37,23,554,303,127,176,9,0,0,0,927,249,119,130,530,47,21,26,39,0,0,0,148,50,17,33
836,8666,685,275,410,0500000US19089,19089,"Howard County, Iowa",Howard County, Iowa,25,15,0,15,150,57,33,24,2,0,0,0,145,48,12,36,48,0,0,0,1,0,0,0,0,0,0,0
837,8743,1032,410,622,0500000US19091,19091,"Humboldt County, Iowa",Humboldt County, Iowa,24,21,20,1,194,63,28,35,0,0,0,0,423,174,106,68,79,0,0,0,13,13,0,13,41,9,7,2
838,6333,727,403,324,0500000US19093,19093,"Ida County, Iowa",Ida County, Iowa,113,6,0,6,60,1,1,0,0,0,0,0,189,42,19,23,5,0,0,0,5,0,0,0,44,0,0,0
839,14945,1123,561,562,0500000US19095,19095,"Iowa County, Iowa",Iowa County, Iowa,83,21,21,0,437,73,19,54,0,0,0,0,477,190,28,162,54,0,0,0,4,0,0,0,56,41,9,32
840,18098,1872,781,1091,0500000US19097,19097,"Jackson County, Iowa",Jackson County, Iowa,133,133,109,24,300,152,93,59,106,0,0,0,276,72,38,34,82,10,10,0,3,1,1,0,43,43,27,16
841,33329,2713,1225,1488,0500000US19099,19099,"Jasper County, Iowa",Jasper County, Iowa,353,40,24,16,706,423,270,153,0,0,0,0,750,66,40,26,183,3,2,1,34,4,0,4,60,0,0,0
842,14323,1670,731,939,0500000US19101,19101,"Jefferson County, Iowa",Jefferson County, Iowa,321,97,65,32,367,46,0,46,0,0,0,0,523,35,27,8,1860,448,281,167,8,0,0,0,39,15,13,2
843,110913,16776,8161,8615,0500000US19103,19103,"Johnson County, Iowa",Johnson County, Iowa,10851,2918,1369,1549,5167,762,354,408,74,50,37,13,8048,1440,739,701,9105,2764,1306,1458,237,0,0,0,2486,371,138,233
844,18333,1741,764,977,0500000US19105,19105,"Jones County, Iowa",Jones County, Iowa,136,25,3,22,441,11,11,0,0,0,0,0,361,57,39,18,176,3,0,3,8,0,0,0,0,0,0,0
845,9616,1165,528,637,0500000US19107,19107,"Keokuk County, Iowa",Keokuk County, Iowa,39,0,0,0,141,35,24,11,2,0,0,0,205,44,18,26,11,0,0,0,9,3,3,0,77,28,7,21
846,13767,1385,592,793,0500000US19109,19109,"Kossuth County, Iowa",Kossuth County, Iowa,170,69,10,59,202,60,31,29,1,0,0,0,465,121,38,83,89,21,8,13,23,15,7,8,67,21,20,1
847,29810,3475,1443,2032,0500000US19111,19111,"Lee County, Iowa",Lee County, Iowa,626,325,97,228,791,125,75,50,6,0,0,0,1216,105,26,79,212,4,0,4,89,0,0,0,141,3,0,3
848,187856,13884,6102,7782,0500000US19113,19113,"Linn County, Iowa",Linn County, Iowa,12052,3534,1881,1653,8120,1842,778,1064,323,134,22,112,7208,960,455,505,4941,150,92,58,420,41,0,41,1392,488,166,322
849,8508,672,241,431,0500000US19115,19115,"Louisa County, Iowa",Louisa County, Iowa,134,78,31,47,225,8,6,2,0,0,0,0,1765,179,84,95,389,73,43,30,26,0,0,0,612,22,10,12
850,8108,1031,523,508,0500000US19117,19117,"Lucas County, Iowa",Lucas County, Iowa,20,20,20,0,107,31,30,1,0,0,0,0,187,132,78,54,0,0,0,0,4,0,0,0,23,2,0,2
851,11064,464,221,243,0500000US19119,19119,"Lyon County, Iowa",Lyon County, Iowa,6,0,0,0,204,27,2,25,33,0,0,0,329,62,24,38,47,0,0,0,40,0,0,0,118,41,20,21
852,15169,887,285,602,0500000US19121,19121,"Madison County, Iowa",Madison County, Iowa,81,0,0,0,193,1,1,0,0,0,0,0,351,5,3,2,157,10,0,10,35,30,0,30,7,5,3,2
853,20196,2379,1117,1262,0500000US19123,19123,"Mahaska County, Iowa",Mahaska County, Iowa,261,190,129,61,416,101,80,21,50,49,49,0,489,43,0,43,287,1,0,1,28,0,0,0,121,0,0,0
854,29820,2103,834,1269,0500000US19125,19125,"Marion County, Iowa",Marion County, Iowa,333,4,0,4,539,30,14,16,11,0,0,0,540,54,2,52,298,56,14,42,59,37,0,37,85,2,0,2
855,26526,2444,969,1475,0500000US19127,19127,"Marshall County, Iowa",Marshall County, Iowa,456,87,50,37,1594,105,11,94,15,0,0,0,8958,1783,758,1025,1466,66,62,4,81,10,10,0,2432,299,157,142
856,13933,798,294,504,0500000US19129,19129,"Mills County, Iowa",Mills County, Iowa,69,0,0,0,221,38,12,26,0,0,0,0,493,182,41,141,58,15,4,11,80,24,0,24,101,27,0,27
857,10013,619,268,351,0500000US19131,19131,"Mitchell County, Iowa",Mitchell County, Iowa,41,1,1,0,76,13,6,7,0,0,0,0,146,40,31,9,44,2,2,0,28,15,0,15,22,7,2,5
858,7983,952,433,519,0500000US19133,19133,"Monona County, Iowa",Monona County, Iowa,26,0,0,0,181,23,0,23,36,18,0,18,189,88,13,75,0,0,0,0,111,1,0,1,5,4,4,0
859,7238,758,291,467,0500000US19135,19135,"Monroe County, Iowa",Monroe County, Iowa,0,0,0,0,260,126,53,73,0,0,0,0,178,123,83,40,22,0,0,0,0,0,0,0,1,1,1,0
860,9165,983,355,628,0500000US19137,19137,"Montgomery County, Iowa",Montgomery County, Iowa,15,0,0,0,229,142,74,68,0,0,0,0,403,123,89,34,9,0,0,0,116,25,0,25,29,0,0,0
861,32018,2748,1109,1639,0500000US19139,19139,"Muscatine County, Iowa",Muscatine County, Iowa,897,212,94,118,1634,388,225,163,12,0,0,0,7665,783,256,527,379,2,0,2,109,25,9,16,1523,232,44,188
862,12426,1218,541,677,0500000US19141,19141,"O'Brien County, Iowa",O'Brien County, Iowa,228,127,84,43,196,16,5,11,4,0,0,0,687,166,73,93,114,0,0,0,29,2,0,2,143,55,18,37
863,5210,591,266,325,0500000US19143,19143,"Osceola County, Iowa",Osceola County, Iowa,52,13,7,6,215,3,0,3,3,0,0,0,498,109,59,50,26,4,0,4,13,5,0,5,95,39,32,7
864,13042,1451,603,848,0500000US19145,19145,"Page County, Iowa",Page County, Iowa,115,29,29,0,339,52,22,30,26,0,0,0,459,231,117,114,144,0,0,0,22,0,0,0,48,9,0,9
865,7928,463,224,239,0500000US19147,19147,"Palo Alto County, Iowa",Palo Alto County, Iowa,129,19,10,9,292,2,2,0,0,0,0,0,264,12,3,9,9,0,0,0,32,4,4,0,31,0,0,0
866,22551,1386,667,719,0500000US19149,19149,"Plymouth County, Iowa",Plymouth County, Iowa,383,1,0,1,221,33,17,16,0,0,0,0,1353,274,64,210,171,41,41,0,135,52,20,32,470,96,50,46
867,6087,598,226,372,0500000US19151,19151,"Pocahontas County, Iowa",Pocahontas County, Iowa,20,20,0,20,101,78,0,78,32,14,0,14,272,27,1,26,54,0,0,0,11,0,0,0,43,16,0,16
868,367012,26630,11605,15025,0500000US19153,19153,"Polk County, Iowa",Polk County, Iowa,32852,9078,4214,4864,17077,3979,1669,2310,417,105,39,66,40673,8496,3712,4784,23073,2476,1205,1271,1096,168,59,109,8513,2036,968,1068
869,79676,7092,2832,4260,0500000US19155,19155,"Pottawattamie County, Iowa",Pottawattamie County, Iowa,1148,116,50,66,2530,328,172,156,11,0,0,0,7329,1845,923,922,687,111,33,78,352,72,3,69,1546,379,198,181
870,15845,1597,645,952,0500000US19157,19157,"Poweshiek County, Iowa",Poweshiek County, Iowa,137,71,2,69,370,103,39,64,0,0,0,0,449,26,7,19,91,29,14,15,2,0,0,0,57,0,0,0
871,4475,465,161,304,0500000US19159,19159,"Ringgold County, Iowa",Ringgold County, Iowa,0,0,0,0,60,0,0,0,0,0,0,0,127,8,0,8,38,0,0,0,10,0,0,0,99,8,0,8
872,8985,893,412,481,0500000US19161,19161,"Sac County, Iowa",Sac County, Iowa,68,0,0,0,98,3,3,0,0,0,0,0,321,99,53,46,38,0,0,0,0,0,0,0,53,7,7,0
873,134004,11198,4840,6358,0500000US19163,19163,"Scott County, Iowa",Scott County, Iowa,12213,5039,2107,2932,7498,1859,919,940,21,0,0,0,11861,1857,861,996,4801,382,167,215,505,125,53,72,1505,270,14,256
874,10662,892,363,529,0500000US19165,19165,"Shelby County, Iowa",Shelby County, Iowa,113,0,0,0,147,12,3,9,0,0,0,0,351,113,47,66,37,0,0,0,19,1,0,1,131,21,16,5
875,28244,1084,501,583,0500000US19167,19167,"Sioux County, Iowa",Sioux County, Iowa,96,0,0,0,972,70,14,56,10,0,0,0,3687,610,284,326,163,23,23,0,86,0,0,0,769,116,53,63
876,70789,12477,6369,6108,0500000US19169,19169,"Story County, Iowa",Story County, Iowa,1942,561,279,282,2913,1065,622,443,0,0,0,0,3132,515,240,275,7731,2587,1818,769,113,32,11,21,1101,151,60,91
877,13155,1492,689,803,0500000US19171,19171,"Tama County, Iowa",Tama County, Iowa,76,13,9,4,589,40,6,34,6,0,0,0,1762,326,88,238,57,31,31,0,1331,231,81,150,130,4,1,3
878,5448,379,138,241,0500000US19173,19173,"Taylor County, Iowa",Taylor County, Iowa,0,0,0,0,178,0,0,0,0,0,0,0,492,53,46,7,9,0,0,0,9,0,0,0,155,0,0,0
879,11278,1280,529,751,0500000US19175,19175,"Union County, Iowa",Union County, Iowa,15,15,15,0,168,4,0,4,0,0,0,0,371,129,13,116,195,0,0,0,0,0,0,0,116,112,13,99
880,6745,822,419,403,0500000US19177,19177,"Van Buren County, Iowa",Van Buren County, Iowa,19,0,0,0,110,37,16,21,0,0,0,0,116,62,48,14,34,1,0,1,0,0,0,0,25,13,8,5
881,27968,4502,2051,2451,0500000US19179,19179,"Wapello County, Iowa",Wapello County, Iowa,1227,520,359,161,1040,202,17,185,303,137,62,75,3770,352,151,201,499,14,14,0,86,7,0,7,1277,83,48,35
882,46008,2696,992,1704,0500000US19181,19181,"Warren County, Iowa",Warren County, Iowa,269,153,91,62,1089,152,61,91,113,90,18,72,1401,226,99,127,340,0,0,0,24,11,11,0,306,92,25,67
883,19617,1523,664,859,0500000US19183,19183,"Washington County, Iowa",Washington County, Iowa,140,57,22,35,405,23,19,4,6,0,0,0,1430,163,61,102,97,1,0,1,45,25,25,0,579,70,34,36
884,6000,941,449,492,0500000US19185,19185,"Wayne County, Iowa",Wayne County, Iowa,6,0,0,0,173,67,24,43,0,0,0,0,103,0,0,0,5,0,0,0,31,0,0,0,35,0,0,0
885,29572,3505,1286,2219,0500000US19187,19187,"Webster County, Iowa",Webster County, Iowa,1024,557,226,331,836,349,93,256,4,0,0,0,1791,549,211,338,460,20,0,20,67,25,21,4,543,21,1,20
886,9059,600,200,400,0500000US19189,19189,"Winnebago County, Iowa",Winnebago County, Iowa,105,0,0,0,124,13,0,13,0,0,0,0,415,68,46,22,115,0,0,0,31,0,0,0,55,27,27,0
887,17129,1347,508,839,0500000US19191,19191,"Winneshiek County, Iowa",Winneshiek County, Iowa,133,1,0,1,107,40,0,40,2,0,0,0,342,94,51,43,120,85,29,56,67,0,0,0,146,15,1,14
888,71586,6842,3020,3822,0500000US19193,19193,"Woodbury County, Iowa",Woodbury County, Iowa,3719,688,332,356,5446,776,503,273,398,141,126,15,17267,3466,1810,1656,2594,456,238,218,1845,743,378,365,2595,267,125,142
889,6856,366,186,180,0500000US19195,19195,"Worth County, Iowa",Worth County, Iowa,59,10,3,7,224,2,0,2,2,2,2,0,225,9,5,4,23,0,0,0,0,0,0,0,39,4,4,0
890,10680,1069,468,601,0500000US19197,19197,"Wright County, Iowa",Wright County, Iowa,17,0,0,0,400,210,144,66,0,0,0,0,1538,588,306,282,12,0,0,0,2,0,0,0,380,115,59,56
891,10895,1476,649,827,0500000US20001,20001,"Allen County, Kansas",Allen County, Kansas,22,7,0,7,492,239,119,120,133,0,0,0,408,125,51,74,116,62,37,25,68,39,0,39,0,0,0,0
892,7285,968,428,540,0500000US20003,20003,"Anderson County, Kansas",Anderson County, Kansas,36,14,14,0,172,13,13,0,0,0,0,0,168,111,46,65,3,0,0,0,56,5,3,2,0,0,0,0
893,13086,1632,472,1160,0500000US20005,20005,"Atchison County, Kansas",Atchison County, Kansas,461,26,23,3,898,259,89,170,0,0,0,0,485,119,7,112,69,10,10,0,52,0,0,0,150,87,1,86
894,4004,726,359,367,0500000US20007,20007,"Barber County, Kansas",Barber County, Kansas,21,8,8,0,75,1,0,1,0,0,0,0,253,157,105,52,28,2,0,2,67,18,12,6,8,0,0,0
895,20704,2666,1303,1363,0500000US20009,20009,"Barton County, Kansas",Barton County, Kansas,279,59,34,25,1097,70,16,54,83,62,24,38,3896,674,182,492,76,34,34,0,278,51,0,51,534,177,40,137
896,12674,1481,730,751,0500000US20011,20011,"Bourbon County, Kansas",Bourbon County, Kansas,357,211,61,150,600,214,113,101,0,0,0,0,342,66,12,54,47,23,10,13,18,6,0,6,121,0,0,0
897,7749,840,277,563,0500000US20013,20013,"Brown County, Kansas",Brown County, Kansas,67,3,3,0,365,67,30,37,4,0,0,0,474,237,85,152,20,0,0,0,918,335,159,176,34,14,14,0
898,57071,5328,2579,2749,0500000US20015,20015,"Butler County, Kansas",Butler County, Kansas,639,28,8,20,2131,213,75,138,11,0,0,0,3031,506,202,304,792,0,0,0,491,71,37,34,351,13,0,13
899,2291,156,54,102,0500000US20017,20017,"Chase County, Kansas",Chase County, Kansas,16,0,0,0,73,7,7,0,0,0,0,0,120,11,6,5,4,0,0,0,20,0,0,0,29,0,0,0
900,2745,434,211,223,0500000US20019,20019,"Chautauqua County, Kansas",Chautauqua County, Kansas,38,34,34,0,225,121,36,85,0,0,0,0,135,70,38,32,11,0,0,0,139,18,15,3,8,0,0,0
901,17272,2249,974,1275,0500000US20021,20021,"Cherokee County, Kansas",Cherokee County, Kansas,59,3,2,1,1367,214,105,109,105,0,0,0,555,69,54,15,35,0,0,0,384,121,56,65,46,0,0,0
902,2396,312,150,162,0500000US20023,20023,"Cheyenne County, Kansas",Cheyenne County, Kansas,0,0,0,0,22,0,0,0,0,0,0,0,180,18,10,8,0,0,0,0,17,0,0,0,78,3,0,3
903,1671,190,67,123,0500000US20025,20025,"Clark County, Kansas",Clark County, Kansas,13,0,0,0,94,0,0,0,0,0,0,0,69,0,0,0,37,9,0,9,6,0,0,0,5,0,0,0
904,7385,550,288,262,0500000US20027,20027,"Clay County, Kansas",Clay County, Kansas,76,0,0,0,89,25,4,21,0,0,0,0,209,0,0,0,46,1,1,0,80,4,4,0,0,0,0,0
905,7753,773,321,452,0500000US20029,20029,"Cloud County, Kansas",Cloud County, Kansas,134,73,36,37,183,19,12,7,0,0,0,0,271,66,36,30,0,0,0,0,29,4,4,0,32,12,12,0
906,7549,862,363,499,0500000US20031,20031,"Coffey County, Kansas",Coffey County, Kansas,68,7,7,0,198,24,19,5,0,0,0,0,227,94,29,65,48,1,0,1,16,0,0,0,9,0,0,0
907,1551,138,71,67,0500000US20033,20033,"Comanche County, Kansas",Comanche County, Kansas,4,0,0,0,47,0,0,0,0,0,0,0,83,9,2,7,0,0,0,0,0,0,0,0,9,0,0,0
908,26203,3207,1152,2055,0500000US20035,20035,"Cowley County, Kansas",Cowley County, Kansas,771,246,144,102,1833,330,194,136,44,25,25,0,3704,785,399,386,643,48,0,48,527,33,0,33,381,95,45,50
909,31838,5794,2682,3112,0500000US20037,20037,"Crawford County, Kansas",Crawford County, Kansas,683,312,149,163,1282,499,227,272,0,0,0,0,2191,384,198,186,732,398,247,151,125,58,10,48,201,74,54,20
910,2597,353,120,233,0500000US20039,20039,"Decatur County, Kansas",Decatur County, Kansas,10,0,0,0,23,1,0,1,0,0,0,0,91,59,19,40,12,6,0,6,15,15,0,15,0,0,0,0
911,16496,1497,690,807,0500000US20041,20041,"Dickinson County, Kansas",Dickinson County, Kansas,200,0,0,0,462,30,0,30,0,0,0,0,876,201,85,116,145,55,38,17,86,31,0,31,105,5,1,4
912,6472,1022,414,608,0500000US20043,20043,"Doniphan County, Kansas",Doniphan County, Kansas,97,22,15,7,118,14,6,8,7,7,0,7,167,36,0,36,0,0,0,0,18,3,1,2,8,0,0,0
913,88481,12252,5958,6294,0500000US20045,20045,"Douglas County, Kansas",Douglas County, Kansas,4788,1065,457,608,6518,1524,740,784,0,0,0,0,7118,1561,678,883,6005,1988,1327,661,2033,643,214,429,1648,470,181,289
914,2067,183,60,123,0500000US20047,20047,"Edwards County, Kansas",Edwards County, Kansas,1,1,1,0,93,24,18,6,0,0,0,0,581,74,34,40,27,0,0,0,17,0,0,0,51,2,0,2
915,2216,379,147,232,0500000US20049,20049,"Elk County, Kansas",Elk County, Kansas,0,0,0,0,105,16,12,4,0,0,0,0,111,8,5,3,11,4,0,4,40,0,0,0,21,0,0,0
916,24748,3370,1540,1830,0500000US20051,20051,"Ellis County, Kansas",Ellis County, Kansas,333,169,73,96,841,125,41,84,65,0,0,0,1581,368,118,250,431,0,0,0,58,11,0,11,182,41,0,41
917,4736,376,155,221,0500000US20053,20053,"Ellsworth County, Kansas",Ellsworth County, Kansas,56,2,1,1,195,41,34,7,0,0,0,0,211,31,21,10,40,0,0,0,51,4,4,0,18,0,0,0
918,14401,1238,413,825,0500000US20055,20055,"Finney County, Kansas",Finney County, Kansas,1208,180,100,80,2990,685,131,554,0,0,0,0,18065,3041,1353,1688,1448,78,21,57,173,1,0,1,1865,313,246,67
919,12899,878,286,592,0500000US20057,20057,"Ford County, Kansas",Ford County, Kansas,598,73,46,27,2773,412,106,306,26,0,0,0,18436,2880,1280,1600,424,2,2,0,161,129,69,60,1807,342,134,208
920,22748,2355,834,1521,0500000US20059,20059,"Franklin County, Kansas",Franklin County, Kansas,140,16,0,16,911,122,84,38,7,0,0,0,1043,292,211,81,77,9,0,9,82,2,2,0,485,70,30,40
921,17788,2215,884,1331,0500000US20061,20061,"Geary County, Kansas",Geary County, Kansas,5965,1262,582,680,2867,602,278,324,298,7,4,3,5402,738,304,434,905,129,45,84,273,127,64,63,1062,145,91,54
922,2438,188,98,90,0500000US20063,20063,"Gove County, Kansas",Gove County, Kansas,18,13,6,7,83,12,2,10,0,0,0,0,53,19,12,7,10,4,0,4,0,0,0,0,9,0,0,0
923,2155,166,65,101,0500000US20065,20065,"Graham County, Kansas",Graham County, Kansas,120,56,1,55,85,45,21,24,0,0,0,0,75,56,0,56,5,5,0,5,0,0,0,0,0,0,0,0
924,3592,171,85,86,0500000US20067,20067,"Grant County, Kansas",Grant County, Kansas,0,0,0,0,158,18,0,18,0,0,0,0,3517,733,228,505,80,0,0,0,10,0,0,0,98,16,16,0
925,4806,203,88,115,0500000US20069,20069,"Gray County, Kansas",Gray County, Kansas,44,0,0,0,176,0,0,0,19,0,0,0,969,70,39,31,20,0,0,0,14,0,0,0,18,0,0,0
926,859,111,38,73,0500000US20071,20071,"Greeley County, Kansas",Greeley County, Kansas,0,0,0,0,41,0,0,0,0,0,0,0,267,5,0,5,0,0,0,0,21,0,0,0,147,4,0,4
927,5435,613,233,380,0500000US20073,20073,"Greenwood County, Kansas",Greenwood County, Kansas,2,0,0,0,219,88,72,16,0,0,0,0,237,34,18,16,23,0,0,0,21,6,1,5,30,0,0,0
928,1515,75,24,51,0500000US20075,20075,"Hamilton County, Kansas",Hamilton County, Kansas,51,0,0,0,41,1,0,1,0,0,0,0,944,137,64,73,0,0,0,0,0,0,0,0,209,0,0,0
929,4814,684,327,357,0500000US20077,20077,"Harper County, Kansas",Harper County, Kansas,0,0,0,0,100,41,8,33,17,0,0,0,342,75,45,30,23,23,23,0,74,14,2,12,70,3,2,1
930,27107,2548,954,1594,0500000US20079,20079,"Harvey County, Kansas",Harvey County, Kansas,456,137,96,41,1572,263,102,161,69,0,0,0,4063,427,251,176,232,0,0,0,58,4,4,0,634,0,0,0
931,2605,264,128,136,0500000US20081,20081,"Haskell County, Kansas",Haskell County, Kansas,0,0,0,0,244,81,57,24,0,0,0,0,1232,161,79,82,5,0,0,0,38,21,6,15,393,25,0,25
932,1599,157,51,106,0500000US20083,20083,"Hodgeman County, Kansas",Hodgeman County, Kansas,0,0,0,0,49,18,11,7,0,0,0,0,175,31,19,12,0,0,0,0,6,0,0,0,4,0,0,0
933,10927,1007,331,676,0500000US20085,20085,"Jackson County, Kansas",Jackson County, Kansas,18,6,3,3,535,71,41,30,14,0,0,0,636,61,17,44,45,19,0,19,1062,233,111,122,84,0,0,0
934,17509,1176,544,632,0500000US20087,20087,"Jefferson County, Kansas",Jefferson County, Kansas,121,5,2,3,470,23,8,15,0,0,0,0,540,11,3,8,3,0,0,0,126,36,20,16,71,0,0,0
935,2636,412,168,244,0500000US20089,20089,"Jewell County, Kansas",Jewell County, Kansas,9,0,0,0,88,34,19,15,6,0,0,0,65,9,4,5,5,0,0,0,19,0,0,0,19,0,0,0
936,469803,16815,6635,10180,0500000US20091,20091,"Johnson County, Kansas",Johnson County, Kansas,27628,3802,1355,2447,21879,1380,596,784,226,0,0,0,46047,5299,2084,3215,31249,2048,857,1191,1564,70,27,43,8048,799,374,425
937,2459,251,92,159,0500000US20093,20093,"Kearny County, Kansas",Kearny County, Kansas,110,92,36,56,35,0,0,0,0,0,0,0,1217,381,95,286,9,0,0,0,1,0,0,0,204,0,0,0
938,6565,417,214,203,0500000US20095,20095,"Kingman County, Kansas",Kingman County, Kansas,19,1,0,1,191,38,11,27,0,0,0,0,264,2,0,2,11,0,0,0,1,0,0,0,16,0,0,0
939,2049,131,51,80,0500000US20097,20097,"Kiowa County, Kansas",Kiowa County, Kansas,10,4,0,4,50,0,0,0,0,0,0,0,147,6,5,1,20,0,0,0,12,3,3,0,48,5,5,0
940,16644,2548,1158,1390,0500000US20099,20099,"Labette County, Kansas",Labette County, Kansas,874,176,78,98,1023,218,117,101,0,0,0,0,932,286,115,171,16,0,0,0,166,2,2,0,170,14,14,0
941,1317,147,93,54,0500000US20101,20101,"Lane County, Kansas",Lane County, Kansas,0,0,0,0,7,0,0,0,3,3,3,0,157,38,22,16,24,0,0,0,12,0,0,0,43,22,22,0
942,61345,3486,1321,2165,0500000US20103,20103,"Leavenworth County, Kansas",Leavenworth County, Kansas,5205,1065,586,479,4133,594,273,321,66,0,0,0,4899,992,441,551,1077,0,0,0,462,104,34,70,1609,442,145,297
943,2752,259,122,137,0500000US20105,20105,"Lincoln County, Kansas",Lincoln County, Kansas,8,0,0,0,121,87,51,36,0,0,0,0,65,0,0,0,0,0,0,0,0,0,0,0,0,0,0,0
944,8960,1345,544,801,0500000US20107,20107,"Linn County, Kansas",Linn County, Kansas,44,4,1,3,131,15,10,5,37,0,0,0,278,97,36,61,169,0,0,0,17,13,0,13,16,0,0,0
945,2483,289,171,118,0500000US20109,20109,"Logan County, Kansas",Logan County, Kansas,0,0,0,0,66,7,3,4,8,8,8,0,170,21,13,8,0,0,0,0,40,0,0,0,25,0,0,0
946,22361,3397,1353,2044,0500000US20111,20111,"Lyon County, Kansas",Lyon County, Kansas,675,269,157,112,2048,192,52,140,0,0,0,0,7081,952,390,562,741,297,151,146,145,58,56,2,609,15,2,13
947,24969,1952,909,1043,0500000US20113,20113,"McPherson County, Kansas",McPherson County, Kansas,279,97,85,12,667,21,2,19,0,0,0,0,1119,247,123,124,186,11,11,0,73,14,14,0,5,5,4,1
948,10353,886,404,482,0500000US20115,20115,"Marion County, Kansas",Marion County, Kansas,57,18,11,7,297,26,6,20,0,0,0,0,389,47,28,19,48,17,15,2,37,0,0,0,28,7,7,0
949,8995,783,301,482,0500000US20117,20117,"Marshall County, Kansas",Marshall County, Kansas,26,3,2,1,298,2,2,0,19,0,0,0,251,0,0,0,40,0,0,0,7,3,2,1,46,0,0,0
950,2963,152,45,107,0500000US20119,20119,"Meade County, Kansas",Meade County, Kansas,23,0,0,0,219,73,7,66,0,0,0,0,898,183,67,116,36,13,0,13,2,0,0,0,428,72,37,35
951,30631,1868,848,1020,0500000US20121,20121,"Miami County, Kansas",Miami County, Kansas,264,23,23,0,654,176,83,93,0,0,0,0,1081,128,36,92,180,13,13,0,331,81,41,40,365,0,0,0
952,5570,682,370,312,0500000US20123,20123,"Mitchell County, Kansas",Mitchell County, Kansas,23,22,22,0,84,27,8,19,0,0,0,0,137,50,10,40,19,2,0,2,44,12,12,0,0,0,0,0
953,24710,4118,1736,2382,0500000US20125,20125,"Montgomery County, Kansas",Montgomery County, Kansas,1606,446,230,216,1727,416,197,219,34,13,13,0,2132,548,245,303,187,33,33,0,1028,205,62,143,593,215,152,63
954,4981,426,169,257,0500000US20127,20127,"Morris County, Kansas",Morris County, Kansas,8,0,0,0,154,12,0,12,0,0,0,0,291,49,26,23,42,0,0,0,12,12,0,12,8,0,0,0
955,1811,268,77,191,0500000US20129,20129,"Morton County, Kansas",Morton County, Kansas,0,0,0,0,241,90,0,90,0,0,0,0,627,83,27,56,57,0,0,0,5,0,0,0,9,0,0,0
956,9257,755,221,534,0500000US20131,20131,"Nemaha County, Kansas",Nemaha County, Kansas,52,5,2,3,189,11,3,8,0,0,0,0,217,21,18,3,18,0,0,0,64,8,8,0,35,0,0,0
957,13852,1709,816,893,0500000US20133,20133,"Neosho County, Kansas",Neosho County, Kansas,187,12,12,0,497,134,77,57,0,0,0,0,923,533,176,357,6,1,1,0,68,20,13,7,40,16,15,1
958,2441,279,119,160,0500000US20135,20135,"Ness County, Kansas",Ness County, Kansas,8,0,0,0,29,0,0,0,0,0,0,0,308,35,11,24,7,0,0,0,2,0,0,0,172,33,11,22
959,4249,328,104,224,0500000US20137,20137,"Norton County, Kansas",Norton County, Kansas,8,0,0,0,85,23,12,11,0,0,0,0,134,42,5,37,35,0,0,0,0,0,0,0,56,42,5,37
960,14477,1777,837,940,0500000US20139,20139,"Osage County, Kansas",Osage County, Kansas,91,24,24,0,519,74,27,47,1,0,0,0,532,148,57,91,38,0,0,0,24,2,0,2,42,0,0,0
961,3186,481,220,261,0500000US20141,20141,"Osborne County, Kansas",Osborne County, Kansas,29,0,0,0,88,4,4,0,0,0,0,0,73,10,0,10,4,0,0,0,7,3,0,3,29,0,0,0
962,5342,509,207,302,0500000US20143,20143,"Ottawa County, Kansas",Ottawa County, Kansas,23,23,23,0,87,5,2,3,0,0,0,0,168,18,8,10,45,0,0,0,59,33,33,0,0,0,0,0
963,4834,467,194,273,0500000US20145,20145,"Pawnee County, Kansas",Pawnee County, Kansas,139,1,1,0,73,0,0,0,0,0,0,0,413,34,21,13,15,0,0,0,8,1,1,0,123,0,0,0
964,4843,607,283,324,0500000US20147,20147,"Phillips County, Kansas",Phillips County, Kansas,63,41,4,37,71,8,1,7,11,0,0,0,173,36,4,32,47,9,5,4,17,14,14,0,3,0,0,0
965,21375,1502,601,901,0500000US20149,20149,"Pottawatomie County, Kansas",Pottawatomie County, Kansas,367,0,0,0,699,50,44,6,0,0,0,0,1242,344,142,202,165,0,0,0,158,4,0,4,65,0,0,0
966,7931,718,250,468,0500000US20151,20151,"Pratt County, Kansas",Pratt County, Kansas,132,82,26,56,359,0,0,0,0,0,0,0,538,127,18,109,14,4,0,4,25,1,1,0,10,0,0,0
967,2189,230,110,120,0500000US20153,20153,"Rawlins County, Kansas",Rawlins County, Kansas,14,0,0,0,36,20,10,10,0,0,0,0,173,1,1,0,3,0,0,0,31,0,0,0,89,1,1,0
968,50336,5729,2478,3251,0500000US20155,20155,"Reno County, Kansas",Reno County, Kansas,877,275,98,177,2844,648,189,459,70,0,0,0,5775,876,341,535,322,72,27,45,550,34,22,12,586,215,122,93
969,4254,332,149,183,0500000US20157,20157,"Republic County, Kansas",Republic County, Kansas,44,41,21,20,43,2,0,2,0,0,0,0,97,9,0,9,16,0,0,0,21,0,0,0,19,0,0,0
970,7360,912,424,488,0500000US20159,20159,"Rice County, Kansas",Rice County, Kansas,117,54,54,0,351,44,41,3,18,0,0,0,1018,163,105,58,37,8,8,0,40,15,15,0,199,0,0,0
971,49707,10329,5045,5284,0500000US20161,20161,"Riley County, Kansas",Riley County, Kansas,3696,1015,488,527,2929,1176,473,703,131,36,0,36,5100,1446,669,777,3388,1158,786,372,270,53,12,41,901,283,68,215
972,4543,245,88,157,0500000US20163,20163,"Rooks County, Kansas",Rooks County, Kansas,70,6,0,6,88,0,0,0,8,8,5,3,107,15,0,15,11,0,0,0,0,0,0,0,16,0,0,0
973,2647,233,143,90,0500000US20165,20165,"Rush County, Kansas",Rush County, Kansas,0,0,0,0,156,5,0,5,0,0,0,0,90,11,4,7,24,0,0,0,0,0,0,0,10,7,0,7
974,6207,656,369,287,0500000US20167,20167,"Russell County, Kansas",Russell County, Kansas,122,0,0,0,297,125,24,101,0,0,0,0,249,177,21,156,0,0,0,0,55,53,53,0,54,54,0,54
975,42529,3883,1478,2405,0500000US20169,20169,"Saline County, Kansas",Saline County, Kansas,1397,196,132,64,2877,739,398,341,13,0,0,0,6135,1272,495,777,1088,76,21,55,166,15,0,15,1062,317,143,174
976,3729,212,70,142,0500000US20171,20171,"Scott County, Kansas",Scott County, Kansas,0,0,0,0,117,69,0,69,0,0,0,0,897,163,10,153,77,0,0,0,0,0,0,0,207,0,0,0
977,343238,31514,14299,17215,0500000US20173,20173,"Sedgwick County, Kansas",Sedgwick County, Kansas,42231,12274,5833,6441,31622,7045,2773,4272,320,22,9,13,75994,16008,7351,8657,21977,3247,1133,2114,4577,557,235,322,20141,4472,2538,1934
978,6082,600,276,324,0500000US20175,20175,"Seward County, Kansas",Seward County, Kansas,846,43,33,10,2165,206,138,68,38,0,0,0,13480,2250,1050,1200,568,2,0,2,176,11,11,0,5433,763,363,400
979,126521,11069,4570,6499,0500000US20177,20177,"Shawnee County, Kansas",Shawnee County, Kansas,13981,3296,1433,1863,8632,1103,383,720,58,14,14,0,22018,3823,1509,2314,2287,125,37,88,1328,170,120,50,6260,1507,588,919
980,2291,102,31,71,0500000US20179,20179,"Sheridan County, Kansas",Sheridan County, Kansas,19,6,6,0,23,0,0,0,0,0,0,0,138,23,0,23,0,0,0,0,15,0,0,0,39,20,0,20
981,4776,333,146,187,0500000US20181,20181,"Sherman County, Kansas",Sherman County, Kansas,33,0,0,0,115,27,5,22,0,0,0,0,681,56,24,32,75,1,1,0,25,0,0,0,294,54,22,32
982,3322,307,125,182,0500000US20183,20183,"Smith County, Kansas",Smith County, Kansas,2,0,0,0,86,40,13,27,0,0,0,0,88,0,0,0,28,0,0,0,15,0,0,0,2,0,0,0
983,3326,390,213,177,0500000US20185,20185,"Stafford County, Kansas",Stafford County, Kansas,0,0,0,0,127,7,7,0,0,0,0,0,541,49,21,28,0,0,0,0,50,29,0,29,42,5,5,0
984,1163,121,42,79,0500000US20187,20187,"Stanton County, Kansas",Stanton County, Kansas,0,0,0,0,109,17,3,14,0,0,0,0,741,281,154,127,0,0,0,0,4,0,0,0,45,4,0,4
985,3247,444,104,340,0500000US20189,20189,"Stevens County, Kansas",Stevens County, Kansas,33,0,0,0,553,127,0,127,0,0,0,0,2013,473,157,316,0,0,0,0,2,0,0,0,435,104,81,23
986,19986,2390,1125,1265,0500000US20191,20191,"Sumner County, Kansas",Sumner County, Kansas,115,47,2,45,718,104,34,70,0,0,0,0,1267,118,50,68,120,23,10,13,280,55,24,31,182,16,4,12
987,6571,443,254,189,0500000US20193,20193,"Thomas County, Kansas",Thomas County, Kansas,131,47,0,47,163,9,0,9,0,0,0,0,500,62,22,40,30,0,0,0,20,20,3,17,66,18,13,5
988,2630,142,91,51,0500000US20195,20195,"Trego County, Kansas",Trego County, Kansas,1,1,1,0,12,5,0,5,0,0,0,0,59,32,4,28,0,0,0,0,1,0,0,0,12,12,0,12
989,6232,332,179,153,0500000US20197,20197,"Wabaunsee County, Kansas",Wabaunsee County, Kansas,41,7,7,0,204,41,10,31,5,0,0,0,279,2,2,0,43,0,0,0,48,1,0,1,41,0,0,0
990,1396,192,79,113,0500000US20199,20199,"Wallace County, Kansas",Wallace County, Kansas,3,0,0,0,56,2,2,0,0,0,0,0,93,2,2,0,9,0,0,0,6,0,0,0,39,0,0,0
991,4979,444,217,227,0500000US20201,20201,"Washington County, Kansas",Washington County, Kansas,4,4,2,2,110,0,0,0,0,0,0,0,214,51,28,23,9,0,0,0,33,0,0,0,43,3,2,1
992,1410,93,16,77,0500000US20203,20203,"Wichita County, Kansas",Wichita County, Kansas,22,0,0,0,32,24,0,24,0,0,0,0,618,72,27,45,23,0,0,0,12,0,0,0,126,27,27,0
993,7744,936,423,513,0500000US20205,20205,"Wilson County, Kansas",Wilson County, Kansas,49,49,3,46,358,129,76,53,0,0,0,0,283,89,64,25,0,0,0,0,19,10,10,0,12,0,0,0
994,2872,374,158,216,0500000US20207,20207,"Woodson County, Kansas",Woodson County, Kansas,4,0,0,0,148,22,0,22,0,0,0,0,8,0,0,0,0,0,0,0,54,12,6,6,5,0,0,0
995,65456,8027,3647,4380,0500000US20209,20209,"Wyandotte County, Kansas",Wyandotte County, Kansas,35147,9435,4203,5232,10625,1625,570,1055,258,0,0,0,48038,9389,3948,5441,8028,2477,1357,1120,812,199,107,92,17584,4344,2087,2257
996,16781,3171,1543,1628,0500000US21001,21001,"Adair County, Kentucky",Adair County, Kentucky,413,26,0,26,434,136,0,136,0,0,0,0,316,62,54,8,81,0,0,0,1,0,0,0,58,50,42,8
997,19720,3673,1509,2164,0500000US21003,21003,"Allen County, Kentucky",Allen County, Kentucky,103,0,0,0,505,17,17,0,0,0,0,0,447,30,0,30,24,0,0,0,0,0,0,0,48,16,0,16
998,20823,2909,1167,1742,0500000US21005,21005,"Anderson County, Kentucky",Anderson County, Kentucky,674,283,151,132,456,148,127,21,11,0,0,0,431,123,102,21,59,0,0,0,0,0,0,0,62,0,0,0
999,7202,1105,430,675,0500000US21007,21007,"Ballard County, Kentucky",Ballard County, Kentucky,352,127,80,47,122,19,0,19,0,0,0,0,108,14,0,14,22,8,4,4,13,0,0,0,5,0,0,0
1000,38680,9205,3963,5242,0500000US21009,21009,"Barren County, Kentucky",Barren County, Kentucky,1489,483,283,200,1451,520,247,273,0,0,0,0,1414,744,335,409,161,0,0,0,33,0,0,0,224,89,29,60
1001,11701,2837,1219,1618,0500000US21011,21011,"Bath County, Kentucky",Bath County, Kentucky,154,46,0,46,190,38,30,8,0,0,0,0,209,5,0,5,48,3,1,2,13,0,0,0,105,0,0,0
1002,24148,7279,3462,3817,0500000US21013,21013,"Bell County, Kentucky",Bell County, Kentucky,554,416,192,224,450,121,76,45,0,0,0,0,315,151,105,46,0,0,0,0,44,36,32,4,58,0,0,0
1003,113761,5937,2294,3643,0500000US21015,21015,"Boone County, Kentucky",Boone County, Kentucky,4279,778,361,417,3719,332,117,215,27,0,0,0,5543,1418,727,691,3099,248,60,188,140,0,0,0,2203,1038,606,432
1004,16652,2378,969,1409,0500000US21017,21017,"Bourbon County, Kentucky",Bourbon County, Kentucky,1304,172,66,106,278,15,8,7,0,0,0,0,1287,202,89,113,32,0,0,0,0,0,0,0,34,0,0,0
1005,42532,6729,2843,3886,0500000US21019,21019,"Boyd County, Kentucky",Boyd County, Kentucky,487,77,17,60,1307,553,291,262,0,0,0,0,790,78,63,15,149,0,0,0,51,2,0,2,543,85,6,79
1006,23313,3354,1305,2049,0500000US21021,21021,"Boyle County, Kentucky",Boyle County, Kentucky,1993,507,344,163,644,57,6,51,0,0,0,0,886,126,102,24,99,23,0,23,61,0,0,0,410,49,41,8
1007,7888,1609,667,942,0500000US21023,21023,"Bracken County, Kentucky",Bracken County, Kentucky,81,2,0,2,115,9,4,5,0,0,0,0,46,8,6,2,81,19,19,0,20,0,0,0,0,0,0,0
1008,12135,3906,1857,2049,0500000US21025,21025,"Breathitt County, Kentucky",Breathitt County, Kentucky,140,140,140,0,48,29,0,29,0,0,0,0,141,105,24,81,42,0,0,0,11,0,0,0,60,24,24,0
1009,18777,3386,1593,1793,0500000US21027,21027,"Breckinridge County, Kentucky",Breckinridge County, Kentucky,314,17,6,11,450,213,51,162,0,0,0,0,302,45,20,25,70,0,0,0,26,0,0,0,44,6,6,0
1010,75324,7196,2915,4281,0500000US21029,21029,"Bullitt County, Kentucky",Bullitt County, Kentucky,965,217,136,81,1857,283,208,75,4,4,0,4,1771,301,195,106,611,67,0,67,111,0,0,0,375,48,48,0
1011,11658,1932,829,1103,0500000US21031,21031,"Butler County, Kentucky",Butler County, Kentucky,37,0,0,0,195,9,0,9,3,0,0,0,425,234,125,109,42,5,0,5,16,0,0,0,108,63,34,29
1012,11404,1602,644,958,0500000US21033,21033,"Caldwell County, Kentucky",Caldwell County, Kentucky,925,569,178,391,52,0,0,0,0,0,0,0,208,78,78,0,0,0,0,0,0,0,0,0,0,0,0,0
1013,31642,5635,2580,3055,0500000US21035,21035,"Calloway County, Kentucky",Calloway County, Kentucky,1120,634,376,258,1062,520,211,309,61,20,20,0,933,302,126,176,427,76,40,36,92,24,24,0,228,72,56,16
1014,83354,9191,4215,4976,0500000US21037,21037,"Campbell County, Kentucky",Campbell County, Kentucky,2336,1032,405,627,1672,381,255,126,21,0,0,0,1932,404,182,222,887,185,64,121,92,35,15,20,346,152,66,86
1015,4369,814,376,438,0500000US21039,21039,"Carlisle County, Kentucky",Carlisle County, Kentucky,60,13,11,2,91,2,2,0,0,0,0,0,113,16,0,16,36,9,0,9,22,6,6,0,10,10,1,9
1016,9188,2173,918,1255,0500000US21041,21041,"Carroll County, Kentucky",Carroll County, Kentucky,280,200,196,4,329,99,69,30,0,0,0,0,718,188,59,129,49,0,0,0,0,0,0,0,231,12,7,5
1017,25252,6183,2845,3338,0500000US21043,21043,"Carter County, Kentucky",Carter County, Kentucky,2,2,0,2,524,296,116,180,0,0,0,0,271,36,34,2,0,0,0,0,75,0,0,0,34,0,0,0
1018,14766,3917,1624,2293,0500000US21045,21045,"Casey County, Kentucky",Casey County, Kentucky,58,40,28,12,133,84,48,36,0,0,0,0,452,24,14,10,37,19,18,1,102,10,8,2,186,0,0,0
1019,41855,7680,3517,4163,0500000US21047,21047,"Christian County, Kentucky",Christian County, Kentucky,13795,2858,922,1936,3033,463,207,256,243,97,31,66,4874,656,234,422,1093,54,24,30,285,10,8,2,799,185,0,185
1020,31812,4402,1733,2669,0500000US21049,21049,"Clark County, Kentucky",Clark County, Kentucky,1586,303,195,108,723,220,96,124,0,0,0,0,1099,697,353,344,234,72,41,31,34,0,0,0,328,160,81,79
1021,17626,5981,2721,3260,0500000US21051,21051,"Clay County, Kentucky",Clay County, Kentucky,474,144,108,36,482,368,227,141,9,9,0,9,119,57,51,6,0,0,0,0,13,0,0,0,30,0,0,0
1022,9529,2137,991,1146,0500000US21053,21053,"Clinton County, Kentucky",Clinton County, Kentucky,4,4,3,1,173,82,39,43,0,0,0,0,294,0,0,0,15,0,0,0,0,0,0,0,123,0,0,0
1023,8327,1272,553,719,0500000US21055,21055,"Crittenden County, Kentucky",Crittenden County, Kentucky,30,0,0,0,120,7,7,0,0,0,0,0,110,10,10,0,21,0,0,0,30,30,0,30,39,0,0,0
1024,6053,1381,607,774,0500000US21057,21057,"Cumberland County, Kentucky",Cumberland County, Kentucky,159,30,0,30,122,8,0,8,0,0,0,0,80,10,7,3,46,0,0,0,0,0,0,0,157,0,0,0
1025,86013,11586,4872,6714,0500000US21059,21059,"Daviess County, Kentucky",Daviess County, Kentucky,4363,1342,605,737,2706,856,444,412,107,8,0,8,3193,1507,747,760,1879,532,186,346,144,0,0,0,913,217,127,90
1026,11416,1843,754,1089,0500000US21061,21061,"Edmonson County, Kentucky",Edmonson County, Kentucky,212,98,89,9,256,80,59,21,0,0,0,0,124,66,9,57,13,0,0,0,24,10,0,10,0,0,0,0
1027,5861,1600,770,830,0500000US21063,21063,"Elliott County, Kentucky",Elliott County, Kentucky,0,0,0,0,5,2,2,0,0,0,0,0,48,48,41,7,0,0,0,0,0,0,0,0,7,7,0,7
1028,13603,3615,1553,2062,0500000US21065,21065,"Estill County, Kentucky",Estill County, Kentucky,8,0,0,0,314,118,73,45,0,0,0,0,173,1,1,0,8,0,0,0,57,48,7,41,13,0,0,0
1029,217326,24887,10888,13999,0500000US21067,21067,"Fayette County, Kentucky",Fayette County, Kentucky,44655,13326,6202,7124,13388,3370,1608,1762,56,0,0,0,22703,6303,3291,3012,12551,1764,775,989,533,126,64,62,9757,2707,1553,1154
1030,13873,2573,1352,1221,0500000US21069,21069,"Fleming County, Kentucky",Fleming County, Kentucky,323,54,28,26,66,32,17,15,0,0,0,0,117,0,0,0,93,77,77,0,24,0,0,0,24,0,0,0
1031,34175,9753,4222,5531,0500000US21071,21071,"Floyd County, Kentucky",Floyd County, Kentucky,353,245,207,38,367,119,55,64,0,0,0,0,314,57,56,1,123,19,19,0,4,0,0,0,56,13,13,0
1032,40241,4679,1976,2703,0500000US21073,21073,"Franklin County, Kentucky",Franklin County, Kentucky,4334,795,492,303,1807,483,123,360,28,0,0,0,1691,485,188,297,941,43,30,13,22,0,0,0,1067,391,152,239
1033,3933,809,417,392,0500000US21075,21075,"Fulton County, Kentucky",Fulton County, Kentucky,1293,544,233,311,223,51,18,33,0,0,0,0,97,53,21,32,7,5,0,5,78,35,1,34,31,0,0,0
1034,7655,1098,524,574,0500000US21077,21077,"Gallatin County, Kentucky",Gallatin County, Kentucky,169,49,33,16,286,91,77,14,0,0,0,0,457,154,118,36,10,0,0,0,0,0,0,0,294,18,18,0
1035,16296,2208,974,1234,0500000US21079,21079,"Garrard County, Kentucky",Garrard County, Kentucky,358,49,23,26,365,61,0,61,0,0,0,0,384,0,0,0,15,0,0,0,36,9,9,0,117,0,0,0
1036,23009,3247,1140,2107,0500000US21081,21081,"Grant County, Kentucky",Grant County, Kentucky,108,0,0,0,723,184,62,122,0,0,0,0,724,13,10,3,53,0,0,0,59,59,0,59,505,13,10,3
1037,31336,4969,2071,2898,0500000US21083,21083,"Graves County, Kentucky",Graves County, Kentucky,1377,765,363,402,1383,782,295,487,116,0,0,0,2551,1145,617,528,194,42,42,0,44,32,32,0,860,571,313,258
1038,24888,6288,2913,3375,0500000US21085,21085,"Grayson County, Kentucky",Grayson County, Kentucky,180,117,33,84,269,27,0,27,8,0,0,0,365,87,37,50,190,0,0,0,93,2,2,0,187,48,28,20
1039,10199,2285,1029,1256,0500000US21087,21087,"Green County, Kentucky",Green County, Kentucky,191,9,9,0,177,19,12,7,0,0,0,0,183,117,37,80,3,0,0,0,83,0,0,0,0,0,0,0
1040,33535,5306,2260,3046,0500000US21089,21089,"Greenup County, Kentucky",Greenup County, Kentucky,352,177,106,71,503,146,81,65,0,0,0,0,378,264,172,92,192,0,0,0,29,0,0,0,17,11,11,0
1041,8237,1096,414,682,0500000US21091,21091,"Hancock County, Kentucky",Hancock County, Kentucky,61,14,0,14,257,206,92,114,0,0,0,0,43,2,0,2,51,8,8,0,5,0,0,0,0,0,0,0
1042,80722,8222,3260,4962,0500000US21093,21093,"Hardin County, Kentucky",Hardin County, Kentucky,12646,2297,1030,1267,6051,682,219,463,368,12,0,12,6070,1237,416,821,2131,230,53,177,241,7,7,0,1459,394,183,211
1043,24322,8231,3791,4440,0500000US21095,21095,"Harlan County, Kentucky",Harlan County, Kentucky,486,238,70,168,475,183,103,80,0,0,0,0,258,110,78,32,86,0,0,0,0,0,0,0,81,22,22,0
1044,17300,2897,1271,1626,0500000US21097,21097,"Harrison County, Kentucky",Harrison County, Kentucky,402,103,66,37,322,114,79,35,2,2,0,2,458,49,27,22,0,0,0,0,2,2,0,2,81,0,0,0
1045,16912,3587,1686,1901,0500000US21099,21099,"Hart County, Kentucky",Hart County, Kentucky,822,302,240,62,250,126,47,79,0,0,0,0,353,122,76,46,90,0,0,0,39,4,0,4,1,0,0,0
1046,38017,6333,2855,3478,0500000US21101,21101,"Henderson County, Kentucky",Henderson County, Kentucky,3222,1057,432,625,1651,451,202,249,14,0,0,0,1150,228,147,81,151,1,1,0,92,5,1,4,561,113,113,0
1047,14491,2463,1207,1256,0500000US21103,21103,"Henry County, Kentucky",Henry County, Kentucky,429,90,40,50,438,182,52,130,24,0,0,0,538,212,58,154,88,0,0,0,0,0,0,0,177,66,12,54
1048,3703,605,258,347,0500000US21105,21105,"Hickman County, Kentucky",Hickman County, Kentucky,383,184,58,126,131,46,46,0,0,0,0,0,92,0,0,0,7,0,0,0,49,13,0,13,32,0,0,0
1049,38630,7187,3020,4167,0500000US21107,21107,"Hopkins County, Kentucky",Hopkins County, Kentucky,2824,732,299,433,1151,354,174,180,5,0,0,0,962,427,253,174,329,0,0,0,77,77,77,0,92,25,7,18
1050,12946,4048,2050,1998,0500000US21109,21109,"Jackson County, Kentucky",Jackson County, Kentucky,29,10,0,10,233,44,30,14,0,0,0,0,26,9,0,9,0,0,0,0,0,0,0,0,0,0,0,0
1051,500058,46771,20394,26377,0500000US21111,21111,"Jefferson County, Kentucky",Jefferson County, Kentucky,165074,42171,18723,23448,26000,3853,1821,2032,499,152,0,152,43131,7415,3292,4123,22719,3366,1473,1893,1030,391,131,260,8598,1088,493,595
1052,45735,5503,2210,3293,0500000US21113,21113,"Jessamine County, Kentucky",Jessamine County, Kentucky,2266,696,257,439,1189,322,191,131,6,0,0,0,1871,198,144,54,788,0,0,0,60,0,0,0,591,36,13,23
1053,21261,4408,1898,2510,0500000US21115,21115,"Johnson County, Kentucky",Johnson County, Kentucky,31,15,0,15,182,89,84,5,0,0,0,0,142,21,21,0,283,163,81,82,23,0,0,0,36,0,0,0
1054,144922,13153,5853,7300,0500000US21117,21117,"Kenton County, Kentucky",Kenton County, Kentucky,7278,2439,1147,1292,5016,1562,961,601,21,0,0,0,5408,1812,878,934,1997,77,16,61,225,27,10,17,2135,1311,722,589
1055,13925,4249,2021,2228,0500000US21119,21119,"Knott County, Kentucky",Knott County, Kentucky,95,44,17,27,130,68,21,47,0,0,0,0,116,66,41,25,25,0,0,0,22,4,4,0,52,14,11,3
1056,29236,9694,4332,5362,0500000US21121,21121,"Knox County, Kentucky",Knox County, Kentucky,146,86,13,73,496,258,102,156,33,0,0,0,357,132,81,51,109,20,0,20,165,99,48,51,19,19,19,0
1057,12662,1602,542,1060,0500000US21123,21123,"Larue County, Kentucky",Larue County, Kentucky,473,224,34,190,208,120,92,28,0,0,0,0,444,259,156,103,61,0,0,0,20,2,2,0,112,42,42,0
1058,57209,12692,5498,7194,0500000US21125,21125,"Laurel County, Kentucky",Laurel County, Kentucky,340,180,74,106,894,167,46,121,0,0,0,0,925,348,318,30,146,45,18,27,238,192,118,74,162,0,0,0
1059,14982,3888,1918,1970,0500000US21127,21127,"Lawrence County, Kentucky",Lawrence County, Kentucky,27,0,0,0,176,7,0,7,0,0,0,0,205,87,51,36,150,0,0,0,1,1,1,0,8,8,8,0
1060,6296,2110,974,1136,0500000US21129,21129,"Lee County, Kentucky",Lee County, Kentucky,48,5,0,5,216,10,0,10,0,0,0,0,32,0,0,0,14,0,0,0,9,9,0,9,7,0,0,0
1061,9356,2930,1352,1578,0500000US21131,21131,"Leslie County, Kentucky",Leslie County, Kentucky,0,0,0,0,242,100,65,35,0,0,0,0,4,0,0,0,29,7,0,7,0,0,0,0,0,0,0,0
1062,20912,6202,2759,3443,0500000US21133,21133,"Letcher County, Kentucky",Letcher County, Kentucky,78,10,2,8,280,61,10,51,0,0,0,0,189,75,35,40,59,0,0,0,33,19,0,19,72,48,48,0
1063,12865,3604,1639,1965,0500000US21135,21135,"Lewis County, Kentucky",Lewis County, Kentucky,42,0,0,0,187,80,23,57,0,0,0,0,0,0,0,0,19,0,0,0,51,51,51,0,0,0,0,0
1064,22573,4286,1931,2355,0500000US21137,21137,"Lincoln County, Kentucky",Lincoln County, Kentucky,603,179,170,9,552,380,175,205,0,0,0,0,415,266,125,141,42,0,0,0,0,0,0,0,155,52,30,22
1065,8670,1113,419,694,0500000US21139,21139,"Livingston County, Kentucky",Livingston County, Kentucky,74,5,5,0,153,104,51,53,2,0,0,0,192,26,5,21,28,0,0,0,6,0,0,0,6,0,0,0
1066,23650,3549,1344,2205,0500000US21141,21141,"Logan County, Kentucky",Logan County, Kentucky,1756,565,277,288,470,151,82,69,0,0,0,0,771,280,102,178,73,37,8,29,16,16,0,16,119,0,0,0
1067,6377,675,255,420,0500000US21143,21143,"Lyon County, Kentucky",Lyon County, Kentucky,253,1,0,1,60,31,6,25,9,9,0,9,138,81,81,0,69,0,0,0,32,8,8,0,3,0,0,0
1068,52928,7191,3190,4001,0500000US21145,21145,"McCracken County, Kentucky",McCracken County, Kentucky,6419,1859,784,1075,2199,419,186,233,41,0,0,0,1677,258,67,191,570,18,13,5,232,4,4,0,381,1,1,0
1069,14962,4665,2313,2352,0500000US21147,21147,"McCreary County, Kentucky",McCreary County, Kentucky,249,176,155,21,372,74,74,0,12,0,0,0,215,19,4,15,154,84,84,0,66,0,0,0,0,0,0,0
1070,8725,1101,461,640,0500000US21149,21149,"McLean County, Kentucky",McLean County, Kentucky,119,31,26,5,68,28,15,13,0,0,0,0,134,5,0,5,21,2,1,1,35,20,0,20,37,5,0,5
1071,77061,12965,5365,7600,0500000US21151,21151,"Madison County, Kentucky",Madison County, Kentucky,3337,970,528,442,1765,490,233,257,244,49,0,49,2160,910,500,410,872,23,0,23,332,61,3,58,526,65,38,27
1072,11924,3435,1703,1732,0500000US21153,21153,"Magoffin County, Kentucky",Magoffin County, Kentucky,0,0,0,0,126,53,53,0,0,0,0,0,138,69,69,0,47,47,47,0,11,11,11,0,4,4,4,0
1073,16149,3342,1263,2079,0500000US21155,21155,"Marion County, Kentucky",Marion County, Kentucky,1186,234,118,116,244,116,111,5,36,0,0,0,498,164,89,75,66,0,0,0,35,28,7,21,115,68,47,21
1074,29376,2970,1348,1622,0500000US21157,21157,"Marshall County, Kentucky",Marshall County, Kentucky,162,14,14,0,552,10,3,7,0,0,0,0,517,68,0,68,47,11,3,8,85,23,10,13,107,68,0,68
1075,10061,1846,937,909,0500000US21159,21159,"Martin County, Kentucky",Martin County, Kentucky,2,1,1,0,44,3,0,3,0,0,0,0,36,0,0,0,0,0,0,0,56,0,0,0,0,0,0,0
1076,14844,2562,959,1603,0500000US21161,21161,"Mason County, Kentucky",Mason County, Kentucky,1049,145,123,22,431,104,52,52,13,0,0,0,359,26,26,0,167,40,20,20,8,8,8,0,80,0,0,0
1077,24971,3092,1115,1977,0500000US21163,21163,"Meade County, Kentucky",Meade County, Kentucky,1027,148,101,47,886,58,16,42,59,0,0,0,1052,100,81,19,198,0,0,0,133,0,0,0,95,14,6,8
1078,6067,1231,674,557,0500000US21165,21165,"Menifee County, Kentucky",Menifee County, Kentucky,9,9,9,0,125,23,22,1,0,0,0,0,178,59,39,20,0,0,0,0,0,0,0,0,0,0,0,0
1079,19460,2697,1069,1628,0500000US21167,21167,"Mercer County, Kentucky",Mercer County, Kentucky,741,27,0,27,463,0,0,0,6,0,0,0,662,79,39,40,169,0,0,0,54,44,28,16,157,0,0,0
1080,9420,2034,802,1232,0500000US21169,21169,"Metcalfe County, Kentucky",Metcalfe County, Kentucky,214,48,12,36,206,115,43,72,0,0,0,0,145,99,43,56,22,9,4,5,34,0,0,0,3,3,3,0
1081,9746,2255,951,1304,0500000US21171,21171,"Monroe County, Kentucky",Monroe County, Kentucky,234,128,58,70,133,49,33,16,2,2,0,2,329,144,87,57,27,0,0,0,27,27,10,17,39,0,0,0
1082,25581,4279,1513,2766,0500000US21173,21173,"Montgomery County, Kentucky",Montgomery County, Kentucky,788,279,98,181,452,209,166,43,0,0,0,0,795,248,169,79,18,0,0,0,160,0,0,0,135,72,57,15
1083,11052,2461,1081,1380,0500000US21175,21175,"Morgan County, Kentucky",Morgan County, Kentucky,50,0,0,0,75,12,0,12,50,0,0,0,187,29,0,29,77,0,0,0,51,0,0,0,57,0,0,0
1084,27674,4103,1899,2204,0500000US21177,21177,"Muhlenberg County, Kentucky",Muhlenberg County, Kentucky,1119,205,88,117,514,34,1,33,23,13,13,0,484,29,29,0,452,40,0,40,51,0,0,0,50,0,0,0
1085,41073,3084,1172,1912,0500000US21179,21179,"Nelson County, Kentucky",Nelson County, Kentucky,2323,112,71,41,813,145,30,115,0,0,0,0,1022,170,57,113,268,16,1,15,39,23,23,0,136,18,0,18
1086,6746,1494,670,824,0500000US21181,21181,"Nicholas County, Kentucky",Nicholas County, Kentucky,63,19,5,14,138,15,6,9,0,0,0,0,108,49,0,49,0,0,0,0,6,0,0,0,49,49,0,49
1087,22157,3172,1414,1758,0500000US21183,21183,"Ohio County, Kentucky",Ohio County, Kentucky,266,11,0,11,226,138,62,76,0,0,0,0,822,469,94,375,45,15,7,8,2,0,0,0,319,171,94,77
1088,55818,2126,948,1178,0500000US21185,21185,"Oldham County, Kentucky",Oldham County, Kentucky,1790,233,173,60,1934,227,124,103,0,0,0,0,2562,398,240,158,1083,27,0,27,90,0,0,0,458,66,45,21
1089,10183,1707,787,920,0500000US21187,21187,"Owen County, Kentucky",Owen County, Kentucky,146,28,25,3,293,176,153,23,0,0,0,0,78,7,7,0,0,0,0,0,0,0,0,0,85,0,0,0
1090,3998,1156,485,671,0500000US21189,21189,"Owsley County, Kentucky",Owsley County, Kentucky,186,42,0,42,81,2,1,1,0,0,0,0,0,0,0,0,4,0,0,0,0,0,0,0,0,0,0,0
1091,13607,2337,1042,1295,0500000US21191,21191,"Pendleton County, Kentucky",Pendleton County, Kentucky,93,80,22,58,357,7,7,0,65,0,0,0,204,58,19,39,105,9,9,0,4,0,0,0,30,8,0,8
1092,24077,4834,2199,2635,0500000US21193,21193,"Perry County, Kentucky",Perry County, Kentucky,513,117,96,21,323,92,34,58,20,14,14,0,227,21,0,21,265,38,0,38,11,11,0,11,30,21,0,21
1093,55693,13675,6153,7522,0500000US21195,21195,"Pike County, Kentucky",Pike County, Kentucky,402,270,152,118,557,229,171,58,20,0,0,0,550,102,0,102,289,36,13,23,74,14,0,14,52,27,20,7
1094,11431,2226,902,1324,0500000US21197,21197,"Powell County, Kentucky",Powell County, Kentucky,1,1,0,1,220,53,0,53,0,0,0,0,233,226,21,205,48,0,0,0,27,0,0,0,8,8,8,0
1095,59550,13025,5592,7433,0500000US21199,21199,"Pulaski County, Kentucky",Pulaski County, Kentucky,547,87,37,50,962,195,84,111,0,0,0,0,1583,822,285,537,516,66,11,55,298,78,48,30,274,174,87,87
1096,1941,557,220,337,0500000US21201,21201,"Robertson County, Kentucky",Robertson County, Kentucky,16,0,0,0,3,0,0,0,0,0,0,0,16,0,0,0,0,0,0,0,0,0,0,0,0,0,0,0
1097,15853,3485,1459,2026,0500000US21203,21203,"Rockcastle County, Kentucky",Rockcastle County, Kentucky,3,0,0,0,239,28,10,18,0,0,0,0,157,22,16,6,24,24,0,24,54,38,0,38,18,0,0,0
1098,20526,5634,2419,3215,0500000US21205,21205,"Rowan County, Kentucky",Rowan County, Kentucky,330,26,26,0,199,59,26,33,0,0,0,0,385,94,85,9,179,63,10,53,0,0,0,0,0,0,0,0
1099,16369,3415,1247,2168,0500000US21207,21207,"Russell County, Kentucky",Russell County, Kentucky,78,32,20,12,282,46,18,28,0,0,0,0,664,280,176,104,129,0,0,0,0,0,0,0,428,229,147,82
1100,47205,4240,1829,2411,0500000US21209,21209,"Scott County, Kentucky",Scott County, Kentucky,2420,450,100,350,2126,298,147,151,0,0,0,0,2423,305,157,148,621,46,46,0,171,0,0,0,1245,254,148,106
1101,37215,3013,1021,1992,0500000US21211,21211,"Shelby County, Kentucky",Shelby County, Kentucky,3005,471,335,136,2085,165,69,96,42,0,0,0,4501,828,375,453,480,124,77,47,0,0,0,0,1608,445,192,253
1102,15210,1766,486,1280,0500000US21213,21213,"Simpson County, Kentucky",Simpson County, Kentucky,1602,248,85,163,569,94,42,52,0,0,0,0,465,97,59,38,148,0,0,0,74,0,0,0,162,101,54,47
1103,17568,1438,602,836,0500000US21215,21215,"Spencer County, Kentucky",Spencer County, Kentucky,281,35,8,27,298,36,36,0,0,0,0,0,466,20,20,0,112,0,0,0,21,1,1,0,61,0,0,0
1104,22022,3436,1074,2362,0500000US21217,21217,"Taylor County, Kentucky",Taylor County, Kentucky,978,339,173,166,666,224,118,106,0,0,0,0,541,47,24,23,194,8,0,8,17,0,0,0,68,6,6,0
1105,10395,1834,699,1135,0500000US21219,21219,"Todd County, Kentucky",Todd County, Kentucky,984,535,175,360,205,32,29,3,0,0,0,0,536,177,72,105,11,0,0,0,0,0,0,0,285,40,19,21
1106,12742,1773,706,1067,0500000US21221,21221,"Trigg County, Kentucky",Trigg County, Kentucky,998,160,94,66,409,170,145,25,0,0,0,0,334,3,0,3,66,36,22,14,0,0,0,0,12,12,8,4
1107,7675,1280,552,728,0500000US21223,21223,"Trimble County, Kentucky",Trimble County, Kentucky,29,29,0,29,243,0,0,0,58,0,0,0,274,153,60,93,0,0,0,0,19,19,19,0,225,153,60,93
1108,11752,1415,686,729,0500000US21225,21225,"Union County, Kentucky",Union County, Kentucky,2147,977,766,211,149,81,67,14,0,0,0,0,155,68,43,25,64,59,59,0,0,0,0,0,54,11,11,0
1109,95660,12890,5423,7467,0500000US21227,21227,"Warren County, Kentucky",Warren County, Kentucky,10769,3332,1490,1842,4271,1238,639,599,535,150,53,97,6707,2128,924,1204,5498,1696,909,787,392,125,77,48,2352,1126,520,606
1110,10272,1314,697,617,0500000US21229,21229,"Washington County, Kentucky",Washington County, Kentucky,889,259,50,209,283,118,31,87,0,0,0,0,178,34,34,0,94,0,0,0,0,0,0,0,21,21,21,0
1111,18721,3930,1747,2183,0500000US21231,21231,"Wayne County, Kentucky",Wayne County, Kentucky,324,29,25,4,228,160,90,70,0,0,0,0,692,343,205,138,18,0,0,0,94,0,0,0,463,310,188,122
1112,11158,2273,1060,1213,0500000US21233,21233,"Webster County, Kentucky",Webster County, Kentucky,513,70,24,46,556,127,11,116,13,0,0,0,713,187,68,119,8,0,0,0,5,0,0,0,171,53,21,32
1113,33158,6733,2819,3914,0500000US21235,21235,"Whitley County, Kentucky",Whitley County, Kentucky,88,29,24,5,319,164,31,133,0,0,0,0,402,95,89,6,149,0,0,0,115,96,96,0,97,17,17,0
1114,6852,2455,1116,1339,0500000US21237,21237,"Wolfe County, Kentucky",Wolfe County, Kentucky,0,0,0,0,113,37,0,37,0,0,0,0,0,0,0,0,10,0,0,0,41,41,41,0,0,0,0,0
1115,22547,2263,1062,1201,0500000US21239,21239,"Woodford County, Kentucky",Woodford County, Kentucky,989,229,67,162,662,106,66,40,0,0,0,0,1736,72,48,24,115,0,0,0,0,0,0,0,340,14,10,4
1116,47492,7090,2675,4415,0500000US22001,22001,"Acadia Parish, Louisiana",Acadia Parish, Louisiana,9530,5050,2117,2933,2849,1854,752,1102,0,0,0,0,1670,478,333,145,76,33,33,0,145,0,0,0,166,9,0,9
1117,16506,2197,929,1268,0500000US22003,22003,"Allen Parish, Louisiana",Allen Parish, Louisiana,3012,694,268,426,507,122,17,105,0,0,0,0,351,39,23,16,112,6,0,6,540,166,11,155,155,17,17,0
1118,84157,4680,1759,2921,0500000US22005,22005,"Ascension Parish, Louisiana",Ascension Parish, Louisiana,27587,6087,2379,3708,4145,394,186,208,33,33,0,33,7176,1197,192,1005,1564,1,1,0,79,15,9,6,2278,601,178,423
1119,14413,2231,801,1430,0500000US22007,22007,"Assumption Parish, Louisiana",Assumption Parish, Louisiana,6662,1520,763,757,313,83,47,36,0,0,0,0,697,183,66,117,21,21,11,10,102,29,29,0,98,0,0,0
1120,24757,4365,1812,2553,0500000US22009,22009,"Avoyelles Parish, Louisiana",Avoyelles Parish, Louisiana,8971,3079,1329,1750,2033,986,428,558,71,0,0,0,725,140,62,78,222,3,0,3,358,149,63,86,54,12,0,12
1121,29722,3680,1529,2151,0500000US22011,22011,"Beauregard Parish, Louisiana",Beauregard Parish, Louisiana,4624,1126,688,438,1063,149,67,82,4,0,0,0,1400,138,69,69,223,9,3,6,77,0,0,0,136,24,0,24
1122,7040,1368,548,820,0500000US22013,22013,"Bienville Parish, Louisiana",Bienville Parish, Louisiana,5543,2361,1105,1256,124,68,17,51,0,0,0,0,258,28,17,11,27,23,1,22,0,0,0,0,146,18,7,11
1123,82164,9362,4316,5046,0500000US22015,22015,"Bossier Parish, Louisiana",Bossier Parish, Louisiana,28653,8322,3557,4765,2534,366,142,224,213,0,0,0,8199,2560,1105,1455,2430,375,157,218,701,91,32,59,1409,171,64,107
1124,105665,13694,5990,7704,0500000US22017,22017,"Caddo Parish, Louisiana",Caddo Parish, Louisiana,117276,38072,16457,21615,6285,1155,511,644,116,0,0,0,6831,1521,793,728,3204,250,140,110,763,125,52,73,2457,885,491,394
1125,134265,15950,6678,9272,0500000US22019,22019,"Calcasieu Parish, Louisiana",Calcasieu Parish, Louisiana,49743,13595,5798,7797,5508,1357,548,809,2,0,0,0,7607,2224,988,1236,2980,465,304,161,481,54,0,54,1958,427,161,266
1126,7741,1570,760,810,0500000US22021,22021,"Caldwell Parish, Louisiana",Caldwell Parish, Louisiana,1608,612,348,264,119,0,0,0,0,0,0,0,107,0,0,0,12,0,0,0,31,23,23,0,81,0,0,0
1127,6252,661,337,324,0500000US22023,22023,"Cameron Parish, Louisiana",Cameron Parish, Louisiana,100,0,0,0,190,0,0,0,0,0,0,0,321,0,0,0,29,0,0,0,41,0,0,0,0,0,0,0
1128,5811,1219,544,675,0500000US22025,22025,"Catahoula Parish, Louisiana",Catahoula Parish, Louisiana,2332,914,426,488,61,12,12,0,0,0,0,0,284,79,0,79,17,0,0,0,4,0,0,0,61,61,0,61
1129,6156,1196,595,601,0500000US22027,22027,"Claiborne Parish, Louisiana",Claiborne Parish, Louisiana,7074,3432,1775,1657,238,58,42,16,0,0,0,0,142,114,61,53,20,0,0,0,10,0,0,0,28,28,13,15
1130,10440,2467,1181,1286,0500000US22029,22029,"Concordia Parish, Louisiana",Concordia Parish, Louisiana,6923,2374,855,1519,276,211,165,46,0,0,0,0,220,184,182,2,0,0,0,0,0,0,0,0,59,17,17,0
1131,16051,1784,918,866,0500000US22031,22031,"De Soto Parish, Louisiana",De Soto Parish, Louisiana,9835,3871,1540,2331,541,158,49,109,8,0,0,0,798,267,178,89,22,0,0,0,181,47,26,21,0,0,0,0
1132,191908,19331,7592,11739,0500000US22033,22033,"East Baton Rouge Parish, Louisiana",East Baton Rouge Parish, Louisiana,198217,47812,21029,26783,11007,1631,719,912,299,0,0,0,18446,5542,2856,2686,13993,1618,890,728,891,230,109,121,9101,3239,1922,1317
1133,1308,360,60,300,0500000US22035,22035,"East Carroll Parish, Louisiana",East Carroll Parish, Louisiana,2888,1771,475,1296,21,0,0,0,0,0,0,0,15,15,0,15,0,0,0,0,0,0,0,0,0,0,0,0
1134,9354,678,350,328,0500000US22037,22037,"East Feliciana Parish, Louisiana",East Feliciana Parish, Louisiana,6092,1644,723,921,254,23,23,0,0,0,0,0,173,32,29,3,75,0,0,0,17,0,0,0,12,0,0,0
1135,21682,4259,1585,2674,0500000US22039,22039,"Evangeline Parish, Louisiana",Evangeline Parish, Louisiana,8666,4443,1997,2446,813,302,60,242,14,14,0,14,414,163,136,27,108,0,0,0,119,2,0,2,254,115,83,32
1136,12402,2619,1225,1394,0500000US22041,22041,"Franklin Parish, Louisiana",Franklin Parish, Louisiana,6188,2647,1088,1559,179,26,12,14,5,0,0,0,83,3,0,3,0,0,0,0,19,0,0,0,0,0,0,0
1137,16439,1998,880,1118,0500000US22043,22043,"Grant Parish, Louisiana",Grant Parish, Louisiana,2246,898,436,462,247,56,19,37,0,0,0,0,137,57,17,40,15,0,0,0,18,18,0,18,91,46,20,26
1138,40631,5880,2089,3791,0500000US22045,22045,"Iberia Parish, Louisiana",Iberia Parish, Louisiana,22179,8004,3179,4825,2589,776,352,424,1,0,0,0,3021,894,501,393,1796,115,58,57,196,0,0,0,1180,650,340,310
1139,14467,1441,570,871,0500000US22047,22047,"Iberville Parish, Louisiana",Iberville Parish, Louisiana,13786,3364,1460,1904,418,64,49,15,0,0,0,0,774,128,98,30,13,0,0,0,0,0,0,0,181,0,0,0
1140,9899,1288,623,665,0500000US22049,22049,"Jackson Parish, Louisiana",Jackson Parish, Louisiana,4084,1446,626,820,141,49,5,44,0,0,0,0,241,128,33,95,103,70,13,57,12,2,0,2,268,169,15,154
1141,224314,19553,8031,11522,0500000US22051,22051,"Jefferson Parish, Louisiana",Jefferson Parish, Louisiana,116547,27780,11615,16165,14901,3421,1730,1691,40,10,0,10,63293,14523,6839,7684,18297,1643,757,886,1591,225,109,116,19437,5964,3251,2713
1142,24126,3602,1460,2142,0500000US22053,22053,"Jefferson Davis Parish, Louisiana",Jefferson Davis Parish, Louisiana,4994,1663,604,1059,835,145,115,30,0,0,0,0,786,83,53,30,62,0,0,0,242,63,0,63,191,36,36,0
1143,155656,15901,6608,9293,0500000US22055,22055,"Lafayette Parish, Louisiana",Lafayette Parish, Louisiana,61054,19909,9268,10641,6749,805,237,568,166,0,0,0,10785,2564,1121,1443,4452,350,224,126,476,73,73,0,2160,780,385,395
1144,73736,9774,4695,5079,0500000US22057,22057,"Lafourche Parish, Louisiana",Lafourche Parish, Louisiana,12473,4620,2032,2588,2835,540,115,425,47,0,0,0,4119,1076,542,534,474,129,79,50,2250,556,244,312,2005,771,427,344
1145,11835,2105,931,1174,0500000US22059,22059,"LaSalle Parish, Louisiana",LaSalle Parish, Louisiana,967,181,67,114,172,60,10,50,32,0,0,0,232,44,20,24,227,0,0,0,152,56,31,25,0,0,0,0
1146,23576,5005,2586,2419,0500000US22061,22061,"Lincoln Parish, Louisiana",Lincoln Parish, Louisiana,17706,7510,3052,4458,610,104,68,36,1,0,0,0,1279,424,260,164,648,212,192,20,38,37,9,28,906,413,311,102
1147,121597,13338,6116,7222,0500000US22063,22063,"Livingston Parish, Louisiana",Livingston Parish, Louisiana,8277,1074,506,568,2871,417,179,238,12,5,0,5,5378,641,293,348,1140,16,16,0,573,66,34,32,1570,465,154,311
1148,3182,451,175,276,0500000US22065,22065,"Madison Parish, Louisiana",Madison Parish, Louisiana,5803,2824,1096,1728,43,15,1,14,0,0,0,0,125,6,0,6,0,0,0,0,7,0,0,0,22,9,0,9
1149,12012,1462,502,960,0500000US22067,22067,"Morehouse Parish, Louisiana",Morehouse Parish, Louisiana,11920,4928,2212,2716,193,24,17,7,0,0,0,0,114,19,18,1,126,18,0,18,34,0,0,0,18,18,18,0
1150,19148,3980,1903,2077,0500000US22069,22069,"Natchitoches Parish, Louisiana",Natchitoches Parish, Louisiana,15779,6657,2796,3861,692,79,19,60,0,0,0,0,903,307,116,191,69,2,2,0,381,5,3,2,1046,466,243,223
1151,115528,11359,5509,5850,0500000US22071,22071,"Orleans Parish, Louisiana",Orleans Parish, Louisiana,224064,68106,29160,38946,9639,1650,654,996,31,0,0,0,20638,4385,2041,2344,10734,1649,775,874,723,216,77,139,6691,2042,822,1220
1152,85576,10333,4414,5919,0500000US22073,22073,"Ouachita Parish, Louisiana",Ouachita Parish, Louisiana,54857,22626,9295,13331,2376,438,272,166,28,0,0,0,3222,657,362,295,1537,203,123,80,249,61,7,54,1391,575,348,227
1153,14660,2136,955,1181,0500000US22075,22075,"Plaquemines Parish, Louisiana",Plaquemines Parish, Louisiana,4434,1306,453,853,1386,233,26,207,17,0,0,0,1725,120,58,62,963,211,99,112,302,91,10,81,297,97,51,46
1154,13013,1678,817,861,0500000US22077,22077,"Pointe Coupee Parish, Louisiana",Pointe Coupee Parish, Louisiana,7496,2559,1229,1330,415,78,23,55,0,0,0,0,606,141,99,42,61,0,0,0,15,0,0,0,155,125,99,26
1155,77086,7487,3522,3965,0500000US22079,22079,"Rapides Parish, Louisiana",Rapides Parish, Louisiana,39846,13691,6050,7641,3595,1037,504,533,18,18,7,11,4166,1217,604,613,1697,233,78,155,847,89,36,53,670,236,71,165
1156,4615,595,236,359,0500000US22081,22081,"Red River Parish, Louisiana",Red River Parish, Louisiana,3347,1519,644,875,136,30,30,0,0,0,0,0,37,14,14,0,0,0,0,0,0,0,0,0,23,23,0,23
1157,11914,2394,1092,1302,0500000US22083,22083,"Richland Parish, Louisiana",Richland Parish, Louisiana,6731,3108,1474,1634,358,53,49,4,0,0,0,0,403,185,70,115,62,0,0,0,5,0,0,0,22,0,0,0
1158,15752,2257,806,1451,0500000US22085,22085,"Sabine Parish, Louisiana",Sabine Parish, Louisiana,3688,1500,645,855,1775,453,175,278,8,0,0,0,946,193,56,137,92,19,14,5,1674,348,187,161,285,63,11,52
1159,28654,5569,2347,3222,0500000US22087,22087,"St. Bernard Parish, Louisiana",St. Bernard Parish, Louisiana,10842,3745,1755,1990,1480,461,202,259,26,4,0,4,4692,1024,407,617,1213,269,139,130,186,16,4,12,778,71,39,32
1160,33723,2049,875,1174,0500000US22089,22089,"St. Charles Parish, Louisiana",St. Charles Parish, Louisiana,13703,3147,1567,1580,1219,42,40,2,0,0,0,0,3253,498,310,188,433,102,51,51,119,7,7,0,1012,250,177,73
1161,4439,438,203,235,0500000US22091,22091,"St. Helena Parish, Louisiana",St. Helena Parish, Louisiana,5214,1815,598,1217,73,4,0,4,0,0,0,0,194,11,9,2,31,0,0,0,61,0,0,0,11,0,0,0
1162,10190,548,213,335,0500000US22093,22093,"St. James Parish, Louisiana",St. James Parish, Louisiana,10289,2386,768,1618,109,49,32,17,36,0,0,0,371,56,38,18,39,0,0,0,0,0,0,0,135,0,0,0
1163,14148,1558,530,1028,0500000US22095,22095,"St. John the Baptist Parish, Louisiana",St. John the Baptist Parish, Louisiana,24294,4569,2011,2558,923,196,133,63,0,0,0,0,2650,246,110,136,464,9,1,8,0,0,0,0,985,5,0,5
1164,44149,7396,3328,4068,0500000US22097,22097,"St. Landry Parish, Louisiana",St. Landry Parish, Louisiana,33757,12125,5302,6823,1157,323,164,159,36,0,0,0,1788,220,47,173,33,0,0,0,228,27,0,27,333,2,0,2
1165,34217,3556,1450,2106,0500000US22099,22099,"St. Martin Parish, Louisiana",St. Martin Parish, Louisiana,15349,4484,1959,2525,1373,608,244,364,0,0,0,0,1613,388,178,210,544,228,96,132,210,20,11,9,361,52,38,14
1166,27629,4240,1889,2351,0500000US22101,22101,"St. Mary Parish, Louisiana",St. Mary Parish, Louisiana,15242,4127,1972,2155,1888,445,190,255,8,7,0,7,3474,616,234,382,731,225,127,98,780,111,39,72,1625,418,209,209
1167,200048,17968,7328,10640,0500000US22103,22103,"St. Tammany Parish, Louisiana",St. Tammany Parish, Louisiana,29595,5030,2023,3007,8558,1895,734,1161,137,0,0,0,14723,3190,1431,1759,3933,777,221,556,1598,253,115,138,2786,862,566,296
1168,81946,10568,4168,6400,0500000US22105,22105,"Tangipahoa Parish, Louisiana",Tangipahoa Parish, Louisiana,38579,13457,6133,7324,3840,754,288,466,22,0,0,0,5574,1290,608,682,808,157,138,19,291,9,0,9,423,88,48,40
1169,1859,309,123,186,0500000US22107,22107,"Tensas Parish, Louisiana",Tensas Parish, Louisiana,2448,1108,486,622,4,0,0,0,0,0,0,0,100,45,36,9,6,6,0,6,0,0,0,0,49,0,0,0
1170,72851,8801,3494,5307,0500000US22109,22109,"Terrebonne Parish, Louisiana",Terrebonne Parish, Louisiana,21150,6850,3188,3662,3250,1098,476,622,13,0,0,0,5657,2349,1153,1196,1115,44,15,29,6343,1879,712,1167,1462,463,114,349
1171,15004,2203,961,1242,0500000US22111,22111,"Union Parish, Louisiana",Union Parish, Louisiana,5217,1981,971,1010,456,132,35,97,6,6,6,0,1061,369,236,133,6,0,0,0,38,6,0,6,454,110,94,16
1172,46064,5773,1942,3831,0500000US22113,22113,"Vermilion Parish, Louisiana",Vermilion Parish, Louisiana,8387,3157,1108,2049,1123,180,77,103,68,60,60,0,2144,528,301,227,1133,120,73,47,201,71,32,39,259,72,24,48
1173,33011,4712,1989,2723,0500000US22115,22115,"Vernon Parish, Louisiana",Vernon Parish, Louisiana,6591,1810,906,904,1807,339,175,164,158,7,7,0,4279,540,263,277,1048,186,60,126,584,137,14,123,999,63,12,51
1174,29456,6093,2639,3454,0500000US22117,22117,"Washington Parish, Louisiana",Washington Parish, Louisiana,13057,4128,1721,2407,713,480,237,243,0,0,0,0,981,203,122,81,41,23,5,18,122,0,0,0,429,0,0,0
1175,23453,4553,1877,2676,0500000US22119,22119,"Webster Parish, Louisiana",Webster Parish, Louisiana,12869,5263,2548,2715,587,248,171,77,14,0,0,0,766,347,193,154,77,5,5,0,156,38,23,15,8,0,0,0
1176,14358,789,291,498,0500000US22121,22121,"West Baton Rouge Parish, Louisiana",West Baton Rouge Parish, Louisiana,10122,3044,1162,1882,391,18,15,3,0,0,0,0,812,133,25,108,0,0,0,0,32,0,0,0,54,0,0,0
1177,8425,1202,443,759,0500000US22123,22123,"West Carroll Parish, Louisiana",West Carroll Parish, Louisiana,1511,775,323,452,180,0,0,0,23,0,0,0,418,26,9,17,0,0,0,0,15,0,0,0,268,18,13,5
1178,7239,310,151,159,0500000US22125,22125,"West Feliciana Parish, Louisiana",West Feliciana Parish, Louisiana,4378,1182,828,354,100,2,1,1,0,0,0,0,95,1,1,0,88,12,0,12,0,0,0,0,0,0,0,0
1179,8662,1114,409,705,0500000US22127,22127,"Winn Parish, Louisiana",Winn Parish, Louisiana,3285,808,317,491,179,26,17,9,0,0,0,0,173,33,11,22,7,0,0,0,21,0,0,0,26,3,3,0
1180,94541,9447,4130,5317,0500000US23001,23001,"Androscoggin County, Maine",Androscoggin County, Maine,2387,912,457,455,5466,1161,675,486,0,0,0,0,1949,141,75,66,804,31,7,24,159,54,13,41,359,170,90,80
1181,61251,8133,3342,4791,0500000US23003,23003,"Aroostook County, Maine",Aroostook County, Maine,622,216,163,53,1205,263,115,148,25,0,0,0,819,211,118,93,174,44,0,44,1253,495,202,293,210,50,41,9
1182,256725,17693,8062,9631,0500000US23005,23005,"Cumberland County, Maine",Cumberland County, Maine,8529,2858,1496,1362,8431,1581,647,934,28,0,0,0,5939,793,402,391,6375,886,392,494,809,127,56,71,1561,54,9,45
1183,27459,3338,1382,1956,0500000US23007,23007,"Franklin County, Maine",Franklin County, Maine,38,0,0,0,822,221,69,152,7,0,0,0,365,28,2,26,135,0,0,0,19,0,0,0,104,1,0,1
1184,50509,4955,2124,2831,0500000US23009,23009,"Hancock County, Maine",Hancock County, Maine,402,123,4,119,894,124,52,72,8,0,0,0,806,75,27,48,664,51,0,51,319,29,0,29,104,32,1,31
1185,112332,13397,5713,7684,0500000US23011,23011,"Kennebec County, Maine",Kennebec County, Maine,811,234,183,51,2483,514,324,190,67,49,27,22,1784,368,215,153,953,156,83,73,514,119,51,68,178,26,4,22
1186,36494,3352,1286,2066,0500000US23013,23013,"Knox County, Maine",Knox County, Maine,95,1,0,1,707,125,57,68,5,5,0,5,529,30,28,2,154,1,1,0,202,0,0,0,211,0,0,0
1187,32064,3278,1258,2020,0500000US23015,23015,"Lincoln County, Maine",Lincoln County, Maine,164,30,30,0,797,86,46,40,0,0,0,0,407,124,84,40,288,47,0,47,127,44,34,10,79,54,46,8
1188,53897,6906,3087,3819,0500000US23017,23017,"Oxford County, Maine",Oxford County, Maine,168,82,28,54,1510,407,190,217,3,0,0,0,789,74,32,42,289,45,7,38,168,30,9,21,140,122,104,18
1189,136027,16951,7855,9096,0500000US23019,23019,"Penobscot County, Maine",Penobscot County, Maine,994,239,98,141,3661,836,289,547,11,5,5,0,1986,764,296,468,986,292,82,210,2007,832,296,536,596,39,39,0
1190,15594,2622,1203,1419,0500000US23021,23021,"Piscataquis County, Maine",Piscataquis County, Maine,107,91,91,0,360,90,48,42,0,0,0,0,318,41,0,41,62,4,4,0,44,0,0,0,161,0,0,0
1191,33351,3551,1515,2036,0500000US23023,23023,"Sagadahoc County, Maine",Sagadahoc County, Maine,232,17,17,0,816,136,69,67,0,0,0,0,654,11,0,11,297,0,0,0,123,15,15,0,60,0,0,0
1192,47624,9192,4166,5026,0500000US23025,23025,"Somerset County, Maine",Somerset County, Maine,302,47,23,24,964,232,79,153,0,0,0,0,544,92,50,42,297,85,40,45,143,79,50,29,58,8,5,3
1193,36986,4583,2068,2515,0500000US23027,23027,"Waldo County, Maine",Waldo County, Maine,142,80,44,36,842,155,59,96,0,0,0,0,597,29,15,14,133,0,0,0,163,31,29,2,228,7,7,0
1194,27197,4566,1914,2652,0500000US23029,23029,"Washington County, Maine",Washington County, Maine,200,35,22,13,747,161,73,88,9,0,0,0,730,178,50,128,111,0,0,0,1617,568,300,268,156,46,10,36
1195,189440,13439,5849,7590,0500000US23031,23031,"York County, Maine",York County, Maine,1821,332,198,134,5164,447,153,294,27,5,0,5,3616,729,554,175,2291,181,60,121,996,0,0,0,453,44,43,1
1196,58863,8578,3957,4621,0500000US24001,24001,"Allegany County, Maryland",Allegany County, Maryland,975,421,237,184,1351,443,240,203,6,0,0,0,867,193,144,49,613,132,0,132,74,45,45,0,83,36,0,36
1197,377933,16010,6665,9345,0500000US24003,24003,"Anne Arundel County, Maryland",Anne Arundel County, Maryland,90004,8651,3687,4964,29705,1245,520,725,192,6,0,6,44752,5092,1857,3235,21709,782,218,564,1116,64,22,42,16643,2756,645,2111
1198,453878,31530,12916,18614,0500000US24005,24005,"Baltimore County, Maryland",Baltimore County, Maryland,236144,27076,11891,15185,28820,4183,1935,2248,750,68,45,23,45014,7704,3596,4108,49625,5382,3103,2279,2082,368,114,254,14618,3487,1744,1743
1199,71062,2457,1053,1404,0500000US24009,24009,"Calvert County, Maryland",Calvert County, Maryland,11302,1044,461,583,4115,210,116,94,46,0,0,0,3799,187,69,118,1732,147,144,3,151,0,0,0,524,33,20,13
1200,24743,2560,994,1566,0500000US24011,24011,"Caroline County, Maryland",Caroline County, Maryland,4443,774,262,512,1225,196,80,116,0,0,0,0,2493,783,333,450,155,0,0,0,94,0,0,0,1050,344,188,156
1201,146225,5988,2465,3523,0500000US24013,24013,"Carroll County, Maryland",Carroll County, Maryland,5262,608,412,196,4348,410,79,331,46,0,0,0,6086,646,262,384,3348,267,121,146,392,0,0,0,1482,172,37,135
1202,85970,6968,3021,3947,0500000US24015,24015,"Cecil County, Maryland",Cecil County, Maryland,6721,1059,692,367,3564,814,514,300,7,0,0,0,4654,841,541,300,1539,164,148,16,81,0,0,0,1143,160,107,53
1203,60893,3753,1947,1806,0500000US24017,24017,"Charles County, Maryland",Charles County, Maryland,75555,4928,2337,2591,9580,944,411,533,39,8,0,8,9568,354,84,270,5024,381,173,208,1028,134,56,78,1881,347,38,309
1204,19776,2209,1114,1095,0500000US24019,24019,"Dorchester County, Maryland",Dorchester County, Maryland,8038,2084,841,1243,1976,414,174,240,0,0,0,0,1824,370,216,154,365,76,21,55,8,0,0,0,619,37,0,37
1205,181914,9462,3717,5745,0500000US24021,24021,"Frederick County, Maryland",Frederick County, Maryland,24473,3590,1550,2040,13589,1014,423,591,160,0,0,0,25019,3151,1380,1771,11218,128,13,115,552,40,15,25,4128,866,286,580
1206,27534,2864,1308,1556,0500000US24023,24023,"Garrett County, Maryland",Garrett County, Maryland,127,14,4,10,421,49,21,28,12,0,0,0,332,72,13,59,121,19,19,0,50,35,0,35,27,14,4,10
1207,189764,9689,4078,5611,0500000US24025,24025,"Harford County, Maryland",Harford County, Maryland,34756,4567,1922,2645,9889,1268,487,781,53,0,0,0,11587,1306,608,698,6842,309,129,180,361,66,36,30,4153,738,423,315
1208,162388,4694,1953,2741,0500000US24027,24027,"Howard County, Maryland",Howard County, Maryland,60502,6465,2742,3723,17654,859,274,585,106,0,0,0,22346,1244,549,695,59316,3088,1706,1382,849,41,41,0,5364,277,6,271
1209,14020,1394,705,689,0500000US24029,24029,"Kent County, Maryland",Kent County, Maryland,2471,357,213,144,479,59,31,28,1,0,0,0,743,121,70,51,44,0,0,0,15,5,2,3,398,72,32,40
1210,448161,15495,6605,8890,0500000US24031,24031,"Montgomery County, Maryland",Montgomery County, Maryland,190790,19898,8207,11691,62361,5082,2151,2931,401,31,0,31,202501,20253,8142,12111,156434,9207,4061,5146,3034,217,129,88,93239,11728,4762,6966
1211,104162,8408,4095,4313,0500000US24033,24033,"Prince George's County, Maryland",Prince George's County, Maryland,557764,41810,16839,24971,35620,3073,1515,1558,337,26,26,0,168608,20037,8058,11979,36556,4189,1873,2316,2900,640,280,360,117941,14944,5939,9005
1212,42486,2147,987,1160,0500000US24035,24035,"Queen Anne's County, Maryland",Queen Anne's County, Maryland,2746,310,134,176,1860,229,87,142,13,0,0,0,2065,288,136,152,549,10,0,10,40,18,18,0,727,270,202,68
1213,81218,4961,1913,3048,0500000US24037,24037,"St. Mary's County, Maryland",St. Mary's County, Maryland,15718,2638,1326,1312,5759,656,209,447,21,0,0,0,5913,439,262,177,2814,106,24,82,67,0,0,0,1142,159,48,111
1214,11945,1741,874,867,0500000US24039,24039,"Somerset County, Maryland",Somerset County, Maryland,6277,1678,651,1027,812,383,163,220,0,0,0,0,639,91,41,50,195,72,42,30,42,4,0,4,89,0,0,0
1215,28440,1854,868,986,0500000US24041,24041,"Talbot County, Maryland",Talbot County, Maryland,3880,549,203,346,1967,354,165,189,0,0,0,0,2536,459,154,305,485,43,6,37,132,17,2,15,346,187,57,130
1216,114171,10895,4636,6259,0500000US24043,24043,"Washington County, Maryland",Washington County, Maryland,11832,3042,1689,1353,7115,2004,891,1113,130,0,0,0,7536,1198,572,626,2489,222,75,147,164,36,28,8,1532,272,53,219
1217,61330,7716,3083,4633,0500000US24045,24045,"Wicomico County, Maryland",Wicomico County, Maryland,26114,5091,2217,2874,3504,1301,736,565,20,0,0,0,5361,1761,969,792,3072,96,25,71,156,0,0,0,1854,611,224,387
1218,41114,2913,1390,1523,0500000US24047,24047,"Worcester County, Maryland",Worcester County, Maryland,6375,1352,623,729,1545,253,99,154,0,0,0,0,1777,254,153,101,608,40,32,8,85,0,0,0,237,34,17,17
1219,157964,17747,7988,9759,0500000US24510,24510,"Baltimore city, Maryland",Baltimore city, Maryland,362937,88067,38385,49682,18145,2505,996,1509,141,59,29,30,31339,5893,2555,3338,13679,2444,999,1445,1787,551,189,362,11795,2102,1025,1077
1220,186402,12047,4982,7065,0500000US25001,25001,"Barnstable County, Massachusetts",Barnstable County, Massachusetts,6003,611,386,225,6781,303,116,187,136,0,0,0,6776,911,359,552,3030,160,35,125,1142,160,9,151,3017,501,249,252
1221,106029,8907,4254,4653,0500000US25003,25003,"Berkshire County, Massachusetts",Berkshire County, Massachusetts,2549,794,463,331,4466,1031,489,542,45,3,0,3,5700,1305,654,651,1848,113,41,72,297,40,22,18,1735,200,110,90
1222,440264,35403,15004,20399,0500000US25005,25005,"Bristol County, Massachusetts",Bristol County, Massachusetts,21965,4132,1524,2608,26815,4811,2259,2552,160,28,10,18,45910,13597,6445,7152,12540,1250,640,610,437,143,112,31,31580,9367,4326,5041
1223,14525,818,354,464,0500000US25007,25007,"Dukes County, Massachusetts",Dukes County, Massachusetts,733,166,85,81,996,106,38,68,0,0,0,0,595,55,55,0,97,54,48,6,297,32,1,31,398,105,69,36
1224,533987,35235,13954,21281,0500000US25009,25009,"Essex County, Massachusetts",Essex County, Massachusetts,32642,5584,2453,3131,36340,5351,2417,2934,157,47,47,0,166276,33854,14913,18941,26840,2413,924,1489,1303,446,185,261,70902,15415,6797,8618
1225,62632,5630,2251,3379,0500000US25011,25011,"Franklin County, Massachusetts",Franklin County, Massachusetts,670,251,138,113,2654,717,293,424,70,0,0,0,2896,523,264,259,1022,278,138,140,116,0,0,0,861,189,99,90
1226,278412,21158,9044,12114,0500000US25013,25013,"Hampden County, Massachusetts",Hampden County, Massachusetts,40050,9661,4340,5321,26293,6894,2706,4188,59,4,4,0,118129,39524,16938,22586,11397,1359,736,623,932,224,37,187,21100,6929,3383,3546
1227,119418,11250,4854,6396,0500000US25015,25015,"Hampshire County, Massachusetts",Hampshire County, Massachusetts,2755,556,272,284,5606,940,420,520,222,24,7,17,7656,1372,631,741,4134,854,328,526,150,69,26,43,1710,291,124,167
1228,1105715,57968,25264,32704,0500000US25017,25017,"Middlesex County, Massachusetts",Middlesex County, Massachusetts,79985,11681,5319,6362,61187,5304,2324,2980,728,106,29,77,123345,21360,9473,11887,191160,17915,8990,8925,3139,843,376,467,43623,6418,2710,3708
1229,8023,326,98,228,0500000US25019,25019,"Nantucket County, Massachusetts",Nantucket County, Massachusetts,1438,125,112,13,550,9,9,0,0,0,0,0,1572,210,138,72,145,30,0,30,110,0,0,0,309,3,3,0
1230,506902,24783,10065,14718,0500000US25021,25021,"Norfolk County, Massachusetts",Norfolk County, Massachusetts,48231,5413,2054,3359,24062,1849,799,1050,231,6,0,6,31458,3622,1585,2037,77922,6005,2851,3154,961,71,0,71,10894,1186,411,775
1231,406712,21284,8271,13013,0500000US25023,25023,"Plymouth County, Massachusetts",Plymouth County, Massachusetts,47008,6486,2604,3882,18515,1746,703,1043,121,52,52,0,20146,3106,1123,1983,7702,376,208,168,721,69,15,54,16029,2362,1056,1306
1232,332538,35407,15702,19705,0500000US25025,25025,"Suffolk County, Massachusetts",Suffolk County, Massachusetts,168404,35306,14918,20388,67887,14144,6598,7546,346,17,5,12,178349,42720,19145,23575,64905,17684,7591,10093,2196,529,225,304,51071,13556,6592,6964
1233,605647,43331,19038,24293,0500000US25027,25027,"Worcester County, Massachusetts",Worcester County, Massachusetts,38749,5596,2414,3182,35059,6105,2816,3289,270,16,0,16,93987,22172,9236,12936,40409,3858,1546,2312,1695,517,217,300,25125,5331,2084,3247
1234,9839,1562,647,915,0500000US26001,26001,"Alcona County, Michigan",Alcona County, Michigan,31,13,13,0,153,42,11,31,2,2,0,2,162,52,48,4,36,0,0,0,73,9,6,3,49,37,37,0
1235,7222,811,392,419,0500000US26003,26003,"Alger County, Michigan",Alger County, Michigan,37,4,2,2,328,27,13,14,0,0,0,0,123,20,10,10,66,4,0,4,328,0,0,0,42,2,0,2
1236,101225,7983,3443,4540,0500000US26005,26005,"Allegan County, Michigan",Allegan County, Michigan,1295,120,44,76,4372,340,168,172,0,0,0,0,8679,1668,722,946,835,69,18,51,434,74,49,25,1949,424,181,243
1237,26563,3643,1644,1999,0500000US26007,26007,"Alpena County, Michigan",Alpena County, Michigan,120,83,74,9,561,172,95,77,32,28,0,28,398,146,88,58,134,0,0,0,92,16,9,7,113,1,1,0
1238,21771,2164,954,1210,0500000US26009,26009,"Antrim County, Michigan",Antrim County, Michigan,85,5,4,1,440,54,22,32,0,0,0,0,541,109,67,42,90,9,9,0,142,50,23,27,123,14,7,7
1239,14029,1916,869,1047,0500000US26011,26011,"Arenac County, Michigan",Arenac County, Michigan,50,31,23,8,295,88,56,32,4,4,0,4,301,75,30,45,33,2,0,2,193,61,40,21,16,11,2,9
1240,5622,670,265,405,0500000US26013,26013,"Baraga County, Michigan",Baraga County, Michigan,26,10,9,1,533,188,83,105,1,0,0,0,102,22,22,0,40,4,0,4,834,119,45,74,15,0,0,0
1241,56558,4244,1704,2540,0500000US26015,26015,"Barry County, Michigan",Barry County, Michigan,319,75,58,17,1239,259,102,157,4,4,0,4,1847,128,94,34,382,70,35,35,147,9,0,9,460,0,0,0
1242,91959,13462,5747,7715,0500000US26017,26017,"Bay County, Michigan",Bay County, Michigan,1469,622,338,284,3400,1185,382,803,76,0,0,0,5684,1460,677,783,584,128,57,71,288,9,3,6,432,51,40,11
1243,16374,1615,805,810,0500000US26019,26019,"Benzie County, Michigan",Benzie County, Michigan,22,7,5,2,357,66,58,8,11,0,0,0,416,72,65,7,78,1,0,1,302,94,10,84,72,0,0,0
1244,112504,12803,5674,7129,0500000US26021,26021,"Berrien County, Michigan",Berrien County, Michigan,21054,8745,3700,5045,6473,1137,442,695,3,0,0,0,8377,1713,853,860,2331,233,137,96,633,66,32,34,2102,477,280,197
1245,37640,5996,2703,3293,0500000US26023,26023,"Branch County, Michigan",Branch County, Michigan,132,38,12,26,1177,71,24,47,14,0,0,0,2079,240,144,96,208,5,0,5,151,7,5,2,494,42,42,0
1246,100758,13233,5808,7425,0500000US26025,26025,"Calhoun County, Michigan",Calhoun County, Michigan,13423,4753,2183,2570,6809,1381,683,698,7,0,0,0,6881,1685,842,843,3053,702,351,351,526,160,91,69,1213,372,157,215
1247,43606,4998,2202,2796,0500000US26027,26027,"Cass County, Michigan",Cass County, Michigan,2552,369,203,166,1638,324,135,189,0,0,0,0,2038,333,178,155,418,39,8,31,527,144,68,76,846,9,0,9
1248,24185,2353,920,1433,0500000US26029,26029,"Charlevoix County, Michigan",Charlevoix County, Michigan,135,21,12,9,608,44,29,15,11,2,2,0,527,52,35,17,97,2,2,0,377,50,14,36,73,3,1,2
1249,22968,3059,1345,1714,0500000US26031,26031,"Cheboygan County, Michigan",Cheboygan County, Michigan,81,32,31,1,1103,99,47,52,3,0,0,0,343,10,3,7,111,1,0,1,452,76,38,38,48,0,0,0
1250,24062,3264,1429,1835,0500000US26033,26033,"Chippewa County, Michigan",Chippewa County, Michigan,449,149,92,57,3657,920,257,663,76,10,0,10,577,200,93,107,320,68,23,45,4975,1262,662,600,214,6,6,0
1251,28773,6381,2957,3424,0500000US26035,26035,"Clare County, Michigan",Clare County, Michigan,83,5,5,0,664,218,95,123,0,0,0,0,637,250,109,141,29,0,0,0,194,49,29,20,105,60,60,0
1252,69792,4973,2212,2761,0500000US26037,26037,"Clinton County, Michigan",Clinton County, Michigan,1313,265,64,201,2718,238,175,63,0,0,0,0,3549,656,272,384,1077,353,225,128,91,42,20,22,655,57,30,27
1253,12895,1906,876,1030,0500000US26039,26039,"Crawford County, Michigan",Crawford County, Michigan,7,0,0,0,325,112,94,18,0,0,0,0,267,154,49,105,112,14,0,14,39,6,6,0,76,40,6,34
1254,32393,4055,1906,2149,0500000US26041,26041,"Delta County, Michigan",Delta County, Michigan,55,42,32,10,1490,265,146,119,5,0,0,0,511,42,41,1,190,74,0,74,771,94,26,68,57,5,5,0
1255,23757,2259,861,1398,0500000US26043,26043,"Dickinson County, Michigan",Dickinson County, Michigan,121,41,39,2,420,54,17,37,0,0,0,0,388,49,30,19,155,12,0,12,204,99,42,57,77,0,0,0
1256,89213,6944,3079,3865,0500000US26045,26045,"Eaton County, Michigan",Eaton County, Michigan,7361,847,468,379,3255,440,188,252,22,0,0,0,5822,702,404,298,2616,245,139,106,575,119,43,76,1365,375,294,81
1257,29283,2518,1121,1397,0500000US26047,26047,"Emmet County, Michigan",Emmet County, Michigan,205,19,14,5,1438,76,12,64,27,18,5,13,600,40,35,5,175,8,0,8,844,113,59,54,365,138,0,138
1258,288566,38710,16666,22044,0500000US26049,26049,"Genesee County, Michigan",Genesee County, Michigan,79644,25990,12316,13674,16595,4475,2198,2277,117,25,11,14,14374,3442,1704,1738,3834,678,210,468,1304,333,140,193,3372,224,70,154
1259,23872,3457,1594,1863,0500000US26051,26051,"Gladwin County, Michigan",Gladwin County, Michigan,75,58,22,36,465,128,38,90,0,0,0,0,453,86,23,63,127,60,20,40,117,26,10,16,41,6,3,3
1260,12739,1825,836,989,0500000US26053,26053,"Gogebic County, Michigan",Gogebic County, Michigan,186,44,25,19,193,36,14,22,18,0,0,0,170,52,24,28,78,16,0,16,397,143,58,85,18,0,0,0
1261,84378,8519,4216,4303,0500000US26055,26055,"Grand Traverse County, Michigan",Grand Traverse County, Michigan,571,141,135,6,2617,311,120,191,101,0,0,0,2548,228,89,139,541,97,25,72,689,13,13,0,425,1,0,1
1262,31346,4658,2022,2636,0500000US26057,26057,"Gratiot County, Michigan",Gratiot County, Michigan,572,135,70,65,834,100,28,72,20,0,0,0,2249,662,377,285,107,7,1,6,98,22,20,2,123,45,45,0
1263,41679,6067,2809,3258,0500000US26059,26059,"Hillsdale County, Michigan",Hillsdale County, Michigan,170,55,55,0,856,157,97,60,0,0,0,0,1037,306,132,174,128,21,16,5,180,92,12,80,170,12,12,0
1264,30499,5457,3091,2366,0500000US26061,26061,"Houghton County, Michigan",Houghton County, Michigan,265,129,83,46,657,177,65,112,30,0,0,0,543,144,95,49,979,429,308,121,190,12,2,10,179,52,52,0
1265,29103,3449,1449,2000,0500000US26063,26063,"Huron County, Michigan",Huron County, Michigan,88,8,1,7,639,197,136,61,0,0,0,0,789,230,85,145,170,4,1,3,53,16,6,10,231,51,19,32
1266,188516,27866,13272,14594,0500000US26065,26065,"Ingham County, Michigan",Ingham County, Michigan,32312,9506,4726,4780,16544,5528,2459,3069,88,15,15,0,22335,4218,1969,2249,17614,3962,2032,1930,1166,290,176,114,3779,599,332,267
1267,54953,5298,2034,3264,0500000US26067,26067,"Ionia County, Michigan",Ionia County, Michigan,1229,187,158,29,1651,376,158,218,7,0,0,0,2960,595,204,391,286,69,40,29,57,11,7,4,595,99,37,62
1268,23217,3443,1708,1735,0500000US26069,26069,"Iosco County, Michigan",Iosco County, Michigan,120,5,4,1,560,58,44,14,2,0,0,0,609,29,16,13,176,18,0,18,268,71,43,28,71,15,7,8
1269,10132,1448,636,812,0500000US26071,26071,"Iron County, Michigan",Iron County, Michigan,68,39,29,10,212,77,32,45,0,0,0,0,230,72,32,40,53,0,0,0,121,18,3,15,20,12,0,12
1270,54389,13064,5897,7167,0500000US26073,26073,"Isabella County, Michigan",Isabella County, Michigan,1224,345,237,108,3013,1030,289,741,7,0,0,0,2546,734,344,390,1042,190,45,145,2179,507,245,262,863,144,85,59
1271,127717,13177,5428,7749,0500000US26075,26075,"Jackson County, Michigan",Jackson County, Michigan,9295,2550,1166,1384,5307,1319,564,755,16,5,0,5,5227,1404,612,792,1286,136,72,64,365,46,0,46,705,209,37,172
1272,197625,22640,10627,12013,0500000US26077,26077,"Kalamazoo County, Michigan",Kalamazoo County, Michigan,27053,7297,3374,3923,14348,3375,1862,1513,99,0,0,0,13287,2870,1217,1653,6204,1130,441,689,501,67,7,60,2528,703,377,326
1273,16505,2604,1199,1405,0500000US26079,26079,"Kalkaska County, Michigan",Kalkaska County, Michigan,171,118,89,29,382,29,9,20,0,0,0,0,351,140,29,111,93,0,0,0,131,20,8,12,27,11,0,11
1274,468357,34188,14168,20020,0500000US26081,26081,"Kent County, Michigan",Kent County, Michigan,59425,15738,6918,8820,35403,7078,3288,3790,222,31,0,31,69320,16400,7735,8665,19791,1683,825,858,2349,387,205,182,22003,4474,2309,2165
1275,2025,201,69,132,0500000US26083,26083,"Keweenaw County, Michigan",Keweenaw County, Michigan,13,5,4,1,28,9,7,2,0,0,0,0,29,6,6,0,0,0,0,0,11,0,0,0,0,0,0,0
1276,9878,1807,866,941,0500000US26085,26085,"Lake County, Michigan",Lake County, Michigan,837,178,106,72,399,85,37,48,1,0,0,0,275,98,72,26,26,0,0,0,107,9,0,9,64,39,39,0
1277,79492,6997,3003,3994,0500000US26087,26087,"Lapeer County, Michigan",Lapeer County, Michigan,185,31,29,2,2209,561,192,369,14,0,0,0,4160,1053,426,627,425,27,0,27,186,7,4,3,799,243,144,99
1278,19308,893,448,445,0500000US26089,26089,"Leelanau County, Michigan",Leelanau County, Michigan,71,42,33,9,573,119,70,49,36,0,0,0,868,222,122,100,113,12,12,0,626,142,46,96,103,3,3,0
1279,81635,8138,3408,4730,0500000US26091,26091,"Lenawee County, Michigan",Lenawee County, Michigan,956,120,89,31,3382,621,316,305,10,0,0,0,7771,1788,772,1016,277,2,1,1,279,39,10,29,663,80,47,33
1280,178206,9178,3828,5350,0500000US26093,26093,"Livingston County, Michigan",Livingston County, Michigan,896,133,100,33,3413,233,127,106,102,0,0,0,4791,252,140,112,1922,135,33,102,424,46,31,15,481,43,43,0
1281,4486,763,394,369,0500000US26095,26095,"Luce County, Michigan",Luce County, Michigan,68,64,44,20,278,10,6,4,0,0,0,0,73,20,5,15,5,0,0,0,362,40,17,23,6,0,0,0
1282,7817,927,442,485,0500000US26097,26097,"Mackinac County, Michigan",Mackinac County, Michigan,342,202,121,81,482,99,60,39,24,0,0,0,192,16,5,11,79,15,0,15,1739,390,217,173,43,3,3,0
1283,674919,56340,24927,31413,0500000US26099,26099,"Macomb County, Michigan",Macomb County, Michigan,100797,17798,7075,10723,27292,3646,1380,2266,595,321,237,84,23393,2904,1347,1557,36353,4333,1760,2573,2444,679,362,317,5252,595,240,355
1284,21215,2232,988,1244,0500000US26101,26101,"Manistee County, Michigan",Manistee County, Michigan,98,45,39,6,952,128,40,88,3,0,0,0,748,94,40,54,68,6,2,4,341,67,24,43,94,3,0,3
1285,58392,8591,3665,4926,0500000US26103,26103,"Marquette County, Michigan",Marquette County, Michigan,558,138,108,30,2234,377,200,177,25,0,0,0,903,323,162,161,502,45,2,43,604,85,32,53,96,71,44,27
1286,26204,3591,1438,2153,0500000US26105,26105,"Mason County, Michigan",Mason County, Michigan,241,71,46,25,594,146,85,61,0,0,0,0,1341,321,157,164,181,50,27,23,237,26,21,5,228,117,37,80
1287,37102,6557,3179,3378,0500000US26107,26107,"Mecosta County, Michigan",Mecosta County, Michigan,971,591,436,155,1050,391,153,238,0,0,0,0,942,224,142,82,364,89,62,27,268,135,62,73,184,74,55,19
1288,20782,2062,938,1124,0500000US26109,26109,"Menominee County, Michigan",Menominee County, Michigan,123,61,53,8,600,165,76,89,0,0,0,0,429,63,44,19,91,32,3,29,444,119,37,82,64,0,0,0
1289,74772,7281,3505,3776,0500000US26111,26111,"Midland County, Michigan",Midland County, Michigan,1120,180,82,98,1959,270,83,187,37,0,0,0,2369,390,135,255,1748,10,4,6,389,142,125,17,496,118,30,88
1290,13951,1784,723,1061,0500000US26113,26113,"Missaukee County, Michigan",Missaukee County, Michigan,43,5,4,1,397,39,16,23,0,0,0,0,460,86,31,55,25,0,0,0,44,1,1,0,108,27,27,0
1291,135019,14324,6043,8281,0500000US26115,26115,"Monroe County, Michigan",Monroe County, Michigan,3490,708,322,386,3776,767,343,424,2,0,0,0,5381,778,371,407,777,104,61,43,410,24,15,9,833,203,96,107
1292,56513,7279,3247,4032,0500000US26117,26117,"Montcalm County, Michigan",Montcalm County, Michigan,404,31,31,0,1638,283,101,182,12,7,0,7,2115,143,47,96,176,6,6,0,356,53,25,28,223,6,6,0
1293,8698,1346,575,771,0500000US26119,26119,"Montmorency County, Michigan",Montmorency County, Michigan,14,7,1,6,203,7,7,0,1,0,0,0,129,36,3,33,7,0,0,0,83,40,2,38,13,0,0,0
1294,128559,13085,6029,7056,0500000US26121,26121,"Muskegon County, Michigan",Muskegon County, Michigan,20880,6597,2939,3658,7556,1755,946,809,20,9,0,9,9515,1726,692,1034,1200,93,4,89,1175,396,168,228,994,141,107,34
1295,43402,6160,2826,3334,0500000US26123,26123,"Newaygo County, Michigan",Newaygo County, Michigan,406,124,82,42,1302,352,197,155,0,0,0,0,2805,1003,440,563,208,62,30,32,319,46,18,28,1389,636,281,355
1296,885604,55059,23691,31368,0500000US26125,26125,"Oakland County, Michigan",Oakland County, Michigan,164145,22966,9349,13617,48074,6572,2757,3815,298,42,23,19,53347,7895,3927,3968,96377,5273,2725,2548,2847,360,106,254,13119,2089,924,1165
1297,21359,2663,1225,1438,0500000US26127,26127,"Oceana County, Michigan",Oceana County, Michigan,228,115,85,30,864,70,26,44,8,7,0,7,3976,820,486,334,38,5,0,5,269,55,35,20,393,37,11,26
1298,19339,3020,1404,1616,0500000US26129,26129,"Ogemaw County, Michigan",Ogemaw County, Michigan,28,15,15,0,411,68,59,9,0,0,0,0,451,15,7,8,154,109,74,35,158,53,30,23,24,0,0,0
1299,5445,880,405,475,0500000US26131,26131,"Ontonagon County, Michigan",Ontonagon County, Michigan,15,6,2,4,133,13,0,13,3,3,0,3,90,14,4,10,28,11,11,0,38,4,4,0,6,0,0,0
1300,21758,3448,1608,1840,0500000US26133,26133,"Osceola County, Michigan",Osceola County, Michigan,133,69,30,39,319,106,56,50,0,0,0,0,436,91,53,38,92,9,9,0,174,98,47,51,34,2,2,0
1301,7813,925,468,457,0500000US26135,26135,"Oscoda County, Michigan",Oscoda County, Michigan,38,15,15,0,180,27,6,21,0,0,0,0,141,58,12,46,12,0,0,0,56,18,6,12,26,13,4,9
1302,22901,2876,1185,1691,0500000US26137,26137,"Otsego County, Michigan",Otsego County, Michigan,150,19,2,17,677,79,20,59,2,2,2,0,437,174,65,109,138,11,11,0,63,12,1,11,48,4,4,0
1303,233055,16411,6384,10027,0500000US26139,26139,"Ottawa County, Michigan",Ottawa County, Michigan,3679,978,632,346,11234,831,409,422,56,27,0,27,28126,3734,1620,2114,7112,534,281,253,1073,34,20,14,7047,824,418,406
1304,11988,1555,674,881,0500000US26141,26141,"Presque Isle County, Michigan",Presque Isle County, Michigan,49,24,17,7,209,63,40,23,0,0,0,0,178,33,17,16,70,0,0,0,45,7,3,4,42,0,0,0
1305,22180,3411,1531,1880,0500000US26143,26143,"Roscommon County, Michigan",Roscommon County, Michigan,61,11,11,0,622,132,87,45,0,0,0,0,462,112,45,67,66,1,0,1,95,17,13,4,19,0,0,0
1306,127813,14720,6035,8685,0500000US26145,26145,"Saginaw County, Michigan",Saginaw County, Michigan,34701,11622,5101,6521,7541,2902,1259,1643,11,0,0,0,16205,4859,2206,2653,2159,228,98,130,465,139,72,67,2299,615,249,366
1307,143183,16318,6797,9521,0500000US26147,26147,"St. Clair County, Michigan",St. Clair County, Michigan,3537,880,381,499,4848,1442,733,709,52,8,8,0,5347,992,400,592,800,56,20,36,261,23,21,2,946,190,41,149
1308,51572,6221,2750,3471,0500000US26149,26149,"St. Joseph County, Michigan",St. Joseph County, Michigan,1095,216,98,118,2828,545,271,274,21,0,0,0,4864,1651,794,857,325,29,3,26,68,9,0,9,862,138,30,108
1309,38074,5511,2261,3250,0500000US26151,26151,"Sanilac County, Michigan",Sanilac County, Michigan,155,57,33,24,862,108,49,59,4,0,0,0,1538,334,164,170,114,43,9,34,81,11,10,1,259,56,24,32
1310,6782,1010,421,589,0500000US26153,26153,"Schoolcraft County, Michigan",Schoolcraft County, Michigan,18,2,1,1,548,72,61,11,0,0,0,0,94,20,20,0,26,2,1,1,470,126,29,97,15,0,0,0
1311,63142,6639,3113,3526,0500000US26155,26155,"Shiawassee County, Michigan",Shiawassee County, Michigan,436,47,18,29,1640,253,137,116,23,0,0,0,1979,258,91,167,171,1,1,0,155,50,18,32,282,139,0,139
1312,48070,6006,2566,3440,0500000US26157,26157,"Tuscola County, Michigan",Tuscola County, Michigan,366,184,131,53,1185,274,133,141,3,0,0,0,1817,330,175,155,231,0,0,0,157,52,32,20,158,22,9,13
1313,60174,6915,2991,3924,0500000US26159,26159,"Van Buren County, Michigan",Van Buren County, Michigan,2701,1231,646,585,3587,535,403,132,29,18,0,18,8712,2454,1214,1240,572,90,79,11,589,295,137,158,3163,961,560,401
1314,244903,27912,13511,14401,0500000US26161,26161,"Washtenaw County, Michigan",Washtenaw County, Michigan,40354,9078,4180,4898,17409,2454,1143,1311,131,61,31,30,16632,2874,1206,1668,30635,6331,3213,3118,1145,85,47,38,3441,538,145,393
1315,853702,115011,53960,61051,0500000US26163,26163,"Wayne County, Michigan",Wayne County, Michigan,662563,206566,92283,114283,57276,11976,4918,7058,426,159,59,100,105008,25530,12360,13170,59141,10728,5246,5482,5891,1538,693,845,39368,11408,5819,5589
1316,30871,4101,1910,2191,0500000US26165,26165,"Wexford County, Michigan",Wexford County, Michigan,264,30,29,1,1040,218,122,96,31,2,0,2,688,156,110,46,164,19,6,13,114,42,29,13,62,22,15,7
1317,14660,1711,735,976,0500000US27001,27001,"Aitkin County, Minnesota",Aitkin County, Minnesota,51,13,12,1,311,39,14,25,9,0,0,0,216,45,22,23,40,0,0,0,335,82,33,49,83,22,0,22
1318,280918,12537,5487,7050,0500000US27003,27003,"Anoka County, Minnesota",Anoka County, Minnesota,23445,3697,1490,2207,14352,1313,452,861,65,0,0,0,16618,1551,474,1077,16096,953,529,424,1818,327,230,97,5767,651,244,407
1319,28858,2350,1011,1339,0500000US27005,27005,"Becker County, Minnesota",Becker County, Minnesota,130,17,9,8,1759,380,176,204,6,0,0,0,714,140,30,110,205,45,0,45,1953,709,350,359,303,1,1,0
1320,31771,4000,2010,1990,0500000US27007,27007,"Beltrami County, Minnesota",Beltrami County, Minnesota,476,310,179,131,2753,734,288,446,36,0,0,0,1074,371,235,136,240,39,0,39,8876,3056,1345,1711,0,0,0,0
1321,35251,2644,1000,1644,0500000US27009,27009,"Benton County, Minnesota",Benton County, Minnesota,1803,333,148,185,1234,189,98,91,0,0,0,0,1077,122,89,33,378,73,40,33,67,19,19,0,537,16,0,16
1322,4654,596,229,367,0500000US27011,27011,"Big Stone County, Minnesota",Big Stone County, Minnesota,0,0,0,0,80,0,0,0,0,0,0,0,91,0,0,0,0,0,0,0,3,0,0,0,9,0,0,0
1323,55966,8241,3491,4750,0500000US27013,27013,"Blue Earth County, Minnesota",Blue Earth County, Minnesota,2572,756,319,437,1852,595,271,324,15,0,0,0,2474,457,210,247,1351,547,278,269,114,32,9,23,444,76,76,0
1324,22330,1319,625,694,0500000US27015,27015,"Brown County, Minnesota",Brown County, Minnesota,168,12,12,0,252,16,4,12,0,0,0,0,1108,284,86,198,160,22,22,0,64,48,41,7,544,241,84,157
1325,30472,2754,1457,1297,0500000US27017,27017,"Carlton County, Minnesota",Carlton County, Minnesota,509,236,219,17,1058,228,128,100,0,0,0,0,409,120,24,96,224,20,8,12,1409,367,182,185,26,11,0,11
1326,90528,2822,1108,1714,0500000US27019,27019,"Carver County, Minnesota",Carver County, Minnesota,1820,321,41,280,2938,30,27,3,11,6,0,6,4296,135,74,61,3162,130,55,75,220,32,11,21,1134,3,0,3
1327,23411,2310,1094,1216,0500000US27021,27021,"Cass County, Minnesota",Cass County, Minnesota,90,30,28,2,1857,337,164,173,5,0,0,0,661,147,103,44,157,13,3,10,2746,994,386,608,409,11,9,2
1328,10071,618,286,332,0500000US27023,27023,"Chippewa County, Minnesota",Chippewa County, Minnesota,123,50,46,4,76,11,5,6,160,41,13,28,894,220,90,130,138,52,38,14,215,151,25,126,572,101,44,57
1329,50947,2905,1199,1706,0500000US27025,27025,"Chisago County, Minnesota",Chisago County, Minnesota,128,15,15,0,1342,225,157,68,8,7,7,0,1233,261,221,40,613,92,79,13,199,13,0,13,82,0,0,0
1330,52456,5374,2238,3136,0500000US27027,27027,"Clay County, Minnesota",Clay County, Minnesota,2223,1228,668,560,1714,238,156,82,69,62,0,62,2889,377,182,195,787,362,154,208,976,340,130,210,284,5,5,0
1331,7391,791,380,411,0500000US27029,27029,"Clearwater County, Minnesota",Clearwater County, Minnesota,5,1,1,0,528,110,44,66,0,0,0,0,199,29,24,5,50,4,4,0,647,330,188,142,24,3,0,3
1332,4549,365,158,207,0500000US27031,27031,"Cook County, Minnesota",Cook County, Minnesota,0,0,0,0,129,24,13,11,1,0,0,0,129,80,46,34,53,8,0,8,501,68,26,42,81,58,34,24
1333,9453,1007,426,581,0500000US27033,27033,"Cottonwood County, Minnesota",Cottonwood County, Minnesota,24,4,4,0,122,33,29,4,75,0,0,0,891,147,83,64,520,117,43,74,13,8,0,8,476,51,14,37
1334,60319,5803,2341,3462,0500000US27035,27035,"Crow Wing County, Minnesota",Crow Wing County, Minnesota,515,192,87,105,1229,192,93,99,0,0,0,0,941,56,9,47,264,3,0,3,502,113,53,60,310,0,0,0
1335,326577,12591,5200,7391,0500000US27037,27037,"Dakota County, Minnesota",Dakota County, Minnesota,27097,3958,2118,1840,19230,1937,895,1042,172,0,0,0,30968,5025,2246,2779,21102,1200,485,715,975,147,55,92,12602,1509,577,932
1336,18894,752,268,484,0500000US27039,27039,"Dodge County, Minnesota",Dodge County, Minnesota,29,16,13,3,395,74,35,39,4,0,0,0,1039,155,95,60,193,8,0,8,57,19,14,5,646,87,63,24
1337,35747,2702,1203,1499,0500000US27041,27041,"Douglas County, Minnesota",Douglas County, Minnesota,61,5,2,3,667,10,7,3,116,0,0,0,643,161,42,119,77,47,33,14,61,11,2,9,176,6,5,1
1338,12032,1119,434,685,0500000US27043,27043,"Faribault County, Minnesota",Faribault County, Minnesota,17,0,0,0,394,63,35,28,0,0,0,0,973,275,138,137,49,7,3,4,11,2,1,1,143,11,9,2
1339,19652,1769,852,917,0500000US27045,27045,"Fillmore County, Minnesota",Fillmore County, Minnesota,94,25,6,19,308,16,5,11,0,0,0,0,350,101,64,37,115,3,3,0,1,1,1,0,128,53,33,20
1340,25270,2042,882,1160,0500000US27047,27047,"Freeborn County, Minnesota",Freeborn County, Minnesota,299,132,120,12,988,139,49,90,4,0,0,0,3007,313,154,159,835,339,161,178,130,77,47,30,828,28,20,8
1341,41396,3219,1537,1682,0500000US27049,27049,"Goodhue County, Minnesota",Goodhue County, Minnesota,478,226,61,165,1318,284,197,87,0,0,0,0,1581,34,11,23,351,57,23,34,346,91,56,35,792,8,1,7
1342,5605,517,175,342,0500000US27051,27051,"Grant County, Minnesota",Grant County, Minnesota,16,3,0,3,103,5,5,0,2,0,0,0,142,36,26,10,1,0,0,0,20,0,0,0,27,10,8,2
1343,838363,50009,22287,27722,0500000US27053,27053,"Hennepin County, Minnesota",Hennepin County, Minnesota,162179,44032,20785,23247,59380,7568,3485,4083,400,56,56,0,85911,15113,6663,8450,88827,7584,3662,3922,8252,2676,1238,1438,42851,8845,4263,4582
1344,17454,1213,452,761,0500000US27055,27055,"Houston County, Minnesota",Houston County, Minnesota,190,42,12,30,471,31,5,26,2,0,0,0,222,106,23,83,102,0,0,0,22,1,1,0,47,1,0,1
1345,19484,1917,941,976,0500000US27057,27057,"Hubbard County, Minnesota",Hubbard County, Minnesota,113,42,21,21,511,51,23,28,0,0,0,0,487,232,122,110,101,27,27,0,407,135,54,81,206,184,112,72
1346,37149,2572,1158,1414,0500000US27059,27059,"Isanti County, Minnesota",Isanti County, Minnesota,174,40,6,34,831,60,15,45,0,0,0,0,853,298,125,173,637,0,0,0,101,35,21,14,113,1,0,1
1347,40062,4555,2089,2466,0500000US27061,27061,"Itasca County, Minnesota",Itasca County, Minnesota,137,51,28,23,1742,223,98,125,52,0,0,0,637,84,32,52,131,39,23,16,1322,523,278,245,88,3,2,1
1348,8948,591,293,298,0500000US27063,27063,"Jackson County, Minnesota",Jackson County, Minnesota,16,1,0,1,199,0,0,0,0,0,0,0,355,64,42,22,219,75,24,51,0,0,0,0,116,27,5,22
1349,15069,1302,655,647,0500000US27065,27065,"Kanabec County, Minnesota",Kanabec County, Minnesota,32,2,0,2,381,59,18,41,2,2,0,2,267,123,86,37,124,21,11,10,72,15,2,13,18,11,8,3
1350,33165,2231,965,1266,0500000US27067,27067,"Kandiyohi County, Minnesota",Kandiyohi County, Minnesota,2065,1012,378,634,1313,113,22,91,0,0,0,0,5329,835,342,493,342,72,4,68,142,100,15,85,1816,176,112,64
1351,3906,450,156,294,0500000US27069,27069,"Kittson County, Minnesota",Kittson County, Minnesota,26,12,1,11,73,17,4,13,0,0,0,0,83,10,0,10,39,11,11,0,17,0,0,0,5,0,0,0
1352,11037,1233,517,716,0500000US27071,27071,"Koochiching County, Minnesota",Koochiching County, Minnesota,35,34,34,0,537,49,42,7,0,0,0,0,151,8,8,0,53,32,0,32,292,107,54,53,90,0,0,0
1353,6172,502,196,306,0500000US27073,27073,"Lac qui Parle County, Minnesota",Lac qui Parle County, Minnesota,24,3,0,3,97,10,7,3,0,0,0,0,151,66,31,35,58,11,0,11,14,0,0,0,84,59,31,28
1354,9916,760,342,418,0500000US27075,27075,"Lake County, Minnesota",Lake County, Minnesota,43,25,18,7,183,30,30,0,0,0,0,0,155,5,5,0,3,0,0,0,56,9,6,3,13,0,0,0
1355,3405,256,92,164,0500000US27077,27077,"Lake of the Woods County, Minnesota",Lake of the Woods County, Minnesota,1,1,0,1,222,36,31,5,0,0,0,0,1,1,0,1,3,0,0,0,69,69,0,69,0,0,0,0
1356,25592,1561,664,897,0500000US27079,27079,"Le Sueur County, Minnesota",Le Sueur County, Minnesota,175,101,33,68,474,16,0,16,2,0,0,0,1791,570,204,366,91,2,0,2,78,18,0,18,469,165,56,109
1357,5233,562,255,307,0500000US27081,27081,"Lincoln County, Minnesota",Lincoln County, Minnesota,9,0,0,0,81,32,19,13,0,0,0,0,112,18,4,14,31,0,0,0,9,3,1,2,3,0,0,0
1358,20410,1849,746,1103,0500000US27083,27083,"Lyon County, Minnesota",Lyon County, Minnesota,689,170,3,167,720,115,62,53,2,1,0,1,1782,874,330,544,1164,234,113,121,52,22,9,13,1063,661,188,473
1359,32046,1811,721,1090,0500000US27085,27085,"McLeod County, Minnesota",McLeod County, Minnesota,220,20,3,17,746,18,5,13,0,0,0,0,2282,588,258,330,212,3,0,3,94,50,50,0,875,375,185,190
1360,2428,252,128,124,0500000US27087,27087,"Mahnomen County, Minnesota",Mahnomen County, Minnesota,52,2,0,2,764,188,91,97,5,0,0,0,255,48,35,13,19,0,0,0,1978,678,339,339,42,5,5,0
1361,8593,558,285,273,0500000US27089,27089,"Marshall County, Minnesota",Marshall County, Minnesota,34,1,0,1,199,1,0,1,0,0,0,0,423,74,25,49,24,1,0,1,37,0,0,0,109,31,7,24
1362,18041,2059,835,1224,0500000US27091,27091,"Martin County, Minnesota",Martin County, Minnesota,77,49,27,22,325,64,10,54,16,2,2,0,946,330,181,149,85,18,18,0,60,0,0,0,171,123,89,34
1363,21356,1398,689,709,0500000US27093,27093,"Meeker County, Minnesota",Meeker County, Minnesota,106,3,3,0,388,65,44,21,0,0,0,0,942,76,32,44,37,0,0,0,13,6,5,1,338,33,21,12
1364,22560,2229,838,1391,0500000US27095,27095,"Mille Lacs County, Minnesota",Mille Lacs County, Minnesota,56,33,30,3,956,190,77,113,39,0,0,0,640,33,18,15,227,0,0,0,1174,330,125,205,163,0,0,0
1365,31227,3012,1223,1789,0500000US27097,27097,"Morrison County, Minnesota",Morrison County, Minnesota,35,12,3,9,707,252,123,129,0,0,0,0,539,51,23,28,130,53,25,28,40,6,0,6,256,24,18,6
1366,30431,2703,966,1737,0500000US27099,27099,"Mower County, Minnesota",Mower County, Minnesota,1387,320,174,146,1127,511,315,196,46,0,0,0,4630,1392,602,790,1924,670,519,151,31,1,1,0,1223,105,39,66
1367,7498,479,182,297,0500000US27101,27101,"Murray County, Minnesota",Murray County, Minnesota,29,7,7,0,108,0,0,0,0,0,0,0,349,82,45,37,97,4,0,4,24,0,0,0,51,10,10,0
1368,28120,1688,926,762,0500000US27103,27103,"Nicollet County, Minnesota",Nicollet County, Minnesota,702,469,246,223,1432,332,25,307,0,0,0,0,1506,177,54,123,369,47,46,1,16,8,8,0,275,4,4,0
1369,12369,1017,451,566,0500000US27105,27105,"Nobles County, Minnesota",Nobles County, Minnesota,872,4,4,0,1488,225,155,70,0,0,0,0,6024,1094,451,643,1267,335,67,268,119,37,21,16,1866,359,151,208
1370,5598,501,208,293,0500000US27107,27107,"Norman County, Minnesota",Norman County, Minnesota,54,16,16,0,210,4,2,2,0,0,0,0,332,54,30,24,34,5,0,5,130,20,15,5,11,5,5,0
1371,122087,6329,2742,3587,0500000US27109,27109,"Olmsted County, Minnesota",Olmsted County, Minnesota,9496,3711,1442,2269,5180,350,219,131,112,14,14,0,7695,1347,536,811,9239,636,301,335,394,17,15,2,1442,373,178,195
1372,53081,4012,1832,2180,0500000US27111,27111,"Otter Tail County, Minnesota",Otter Tail County, Minnesota,600,281,92,189,1424,330,171,159,0,0,0,0,2051,468,153,315,246,0,0,0,218,37,18,19,826,11,1,10
1373,12585,1310,606,704,0500000US27113,27113,"Pennington County, Minnesota",Pennington County, Minnesota,177,1,0,1,255,21,21,0,0,0,0,0,551,38,11,27,129,30,11,19,243,66,43,23,24,10,10,0
1374,25001,2462,1232,1230,0500000US27115,27115,"Pine County, Minnesota",Pine County, Minnesota,318,14,13,1,777,145,75,70,18,0,0,0,721,113,51,62,153,27,1,26,559,157,52,105,148,5,5,0
1375,7860,603,281,322,0500000US27117,27117,"Pipestone County, Minnesota",Pipestone County, Minnesota,99,72,13,59,314,137,48,89,16,16,16,0,660,122,46,76,71,2,0,2,122,48,19,29,66,21,5,16
1376,26095,2403,863,1540,0500000US27119,27119,"Polk County, Minnesota",Polk County, Minnesota,669,154,109,45,1127,258,120,138,5,0,0,0,2040,694,297,397,247,7,6,1,353,92,51,41,702,178,64,114
1377,10375,836,420,416,0500000US27121,27121,"Pope County, Minnesota",Pope County, Minnesota,46,8,0,8,212,11,0,11,0,0,0,0,186,56,0,56,78,1,0,1,32,3,0,3,62,0,0,0
1378,322713,23199,10386,12813,0500000US27123,27123,"Ramsey County, Minnesota",Ramsey County, Minnesota,62725,17852,8196,9656,29737,5663,2453,3210,157,17,9,8,40415,7783,3370,4413,79970,16965,8181,8784,3598,1624,731,893,14211,1943,978,965
1379,3670,356,179,177,0500000US27125,27125,"Red Lake County, Minnesota",Red Lake County, Minnesota,30,4,4,0,119,14,10,4,0,0,0,0,147,22,9,13,0,0,0,0,75,33,8,25,0,0,0,0
1380,12917,1039,508,531,0500000US27127,27127,"Redwood County, Minnesota",Redwood County, Minnesota,80,0,0,0,386,129,57,72,0,0,0,0,520,56,32,24,395,96,68,28,665,92,59,33,262,18,18,0
1381,12378,945,431,514,0500000US27129,27129,"Renville County, Minnesota",Renville County, Minnesota,58,29,21,8,271,59,17,42,0,0,0,0,1251,277,86,191,108,8,3,5,177,97,43,54,936,186,72,114
1382,48691,3341,1443,1898,0500000US27131,27131,"Rice County, Minnesota",Rice County, Minnesota,2889,1145,416,729,1901,253,109,144,31,0,0,0,4756,1149,440,709,800,117,55,62,144,26,9,17,2298,918,318,600
1383,8549,810,343,467,0500000US27133,27133,"Rock County, Minnesota",Rock County, Minnesota,46,0,0,0,103,9,7,2,0,0,0,0,263,36,0,36,102,0,0,0,78,14,6,8,26,0,0,0
1384,13624,1003,467,536,0500000US27135,27135,"Roseau County, Minnesota",Roseau County, Minnesota,137,6,6,0,428,19,7,12,0,0,0,0,211,50,24,26,403,11,0,11,265,67,28,39,40,9,4,5
1385,173991,21401,10500,10901,0500000US27137,27137,"St. Louis County, Minnesota",St. Louis County, Minnesota,2226,972,347,625,6720,1700,884,816,71,19,6,13,3217,555,246,309,1729,480,222,258,3313,1427,635,792,1860,223,115,108
1386,116635,4091,1694,2397,0500000US27139,27139,"Scott County, Minnesota",Scott County, Minnesota,6167,1714,774,940,5839,248,119,129,38,0,0,0,7694,1090,509,581,8507,498,241,257,957,78,35,43,3191,228,78,150
1387,85183,3062,1145,1917,0500000US27141,27141,"Sherburne County, Minnesota",Sherburne County, Minnesota,2258,578,346,232,2704,594,249,345,0,0,0,0,2286,359,161,198,1166,251,139,112,341,171,36,135,1199,143,57,86
1388,12982,807,299,508,0500000US27143,27143,"Sibley County, Minnesota",Sibley County, Minnesota,126,2,2,0,315,57,35,22,6,3,3,0,1345,272,135,137,99,14,14,0,36,6,2,4,346,15,15,0
1389,129977,10960,4891,6069,0500000US27145,27145,"Stearns County, Minnesota",Stearns County, Minnesota,10528,4749,2180,2569,4446,1029,355,674,5,5,5,0,5192,942,471,471,3122,872,683,189,228,30,21,9,2313,419,204,215
1390,31233,1929,959,970,0500000US27147,27147,"Steele County, Minnesota",Steele County, Minnesota,1246,426,171,255,843,67,18,49,22,0,0,0,2867,361,164,197,156,3,3,0,135,113,38,75,1093,82,36,46
1391,8281,836,305,531,0500000US27149,27149,"Stevens County, Minnesota",Stevens County, Minnesota,141,37,1,36,185,45,41,4,19,19,0,19,639,82,32,50,184,118,99,19,127,86,20,66,247,32,6,26
1392,8308,587,267,320,0500000US27151,27151,"Swift County, Minnesota",Swift County, Minnesota,144,53,22,31,133,42,21,21,81,78,32,46,489,237,113,124,22,0,0,0,37,37,0,37,153,79,58,21
1393,21743,2841,1438,1403,0500000US27153,27153,"Todd County, Minnesota",Todd County, Minnesota,134,32,24,8,847,212,63,149,7,0,0,0,1479,230,108,122,160,6,2,4,149,0,0,0,487,59,35,24
1394,2797,152,71,81,0500000US27155,27155,"Traverse County, Minnesota",Traverse County, Minnesota,7,3,3,0,87,38,7,31,0,0,0,0,117,51,27,24,4,0,0,0,202,38,21,17,41,1,1,0
1395,20199,1291,599,692,0500000US27157,27157,"Wabasha County, Minnesota",Wabasha County, Minnesota,104,24,0,24,260,18,6,12,0,0,0,0,642,239,159,80,120,38,33,5,81,17,13,4,239,117,67,50
1396,12356,1745,846,899,0500000US27159,27159,"Wadena County, Minnesota",Wadena County, Minnesota,104,75,74,1,518,83,75,8,0,0,0,0,276,7,2,5,44,3,3,0,107,33,17,16,82,6,0,6
1397,16056,1022,428,594,0500000US27161,27161,"Waseca County, Minnesota",Waseca County, Minnesota,140,115,55,60,337,51,19,32,2,0,0,0,955,234,49,185,147,14,5,9,165,4,0,4,179,108,0,108
1398,209549,7825,3474,4351,0500000US27163,27163,"Washington County, Minnesota",Washington County, Minnesota,11330,1264,543,721,9066,601,229,372,165,10,0,10,11086,924,361,563,15871,741,349,392,557,88,52,36,2502,175,100,75
1399,7654,743,294,449,0500000US27165,27165,"Watonwan County, Minnesota",Watonwan County, Minnesota,42,0,0,0,251,23,0,23,0,0,0,0,2819,607,272,335,181,16,2,14,0,0,0,0,1350,261,134,127
1400,5722,472,203,269,0500000US27167,27167,"Wilkin County, Minnesota",Wilkin County, Minnesota,42,0,0,0,123,62,12,50,0,0,0,0,196,99,70,29,5,0,0,0,83,0,0,0,73,58,29,29
1401,43142,5549,2550,2999,0500000US27169,27169,"Winona County, Minnesota",Winona County, Minnesota,433,87,39,48,1134,138,34,104,0,0,0,0,1307,265,91,174,1200,218,187,31,140,80,54,26,342,81,23,58
1402,124100,5699,2561,3138,0500000US27171,27171,"Wright County, Minnesota",Wright County, Minnesota,2300,110,89,21,2883,536,177,359,0,0,0,0,4090,561,175,386,1742,160,54,106,354,30,11,19,1479,157,56,101
1403,8591,724,309,415,0500000US27173,27173,"Yellow Medicine County, Minnesota",Yellow Medicine County, Minnesota,60,20,15,5,240,56,22,34,0,0,0,0,468,53,34,19,49,0,0,0,211,30,4,26,129,0,0,0
1404,10151,1666,828,838,0500000US28001,28001,"Adams County, Mississippi",Adams County, Mississippi,16078,6709,2741,3968,417,129,81,48,0,0,0,0,2006,904,454,450,170,94,50,44,39,37,0,37,498,30,30,0
1405,29676,3949,1561,2388,0500000US28003,28003,"Alcorn County, Mississippi",Alcorn County, Mississippi,4252,1482,981,501,969,323,128,195,0,0,0,0,1191,196,114,82,122,38,0,38,102,0,0,0,337,19,19,0
1406,7018,1090,404,686,0500000US28005,28005,"Amite County, Mississippi",Amite County, Mississippi,5039,2683,1149,1534,98,3,2,1,0,0,0,0,0,0,0,0,37,0,0,0,2,0,0,0,31,0,0,0
1407,9521,1109,442,667,0500000US28007,28007,"Attala County, Mississippi",Attala County, Mississippi,7813,2973,1148,1825,272,102,40,62,0,0,0,0,374,22,11,11,38,11,11,0,15,0,0,0,299,0,0,0
1408,4939,740,262,478,0500000US28009,28009,"Benton County, Mississippi",Benton County, Mississippi,2769,548,318,230,278,121,24,97,26,0,0,0,225,130,77,53,0,0,0,0,0,0,0,0,124,67,39,28
1409,9378,1259,592,667,0500000US28011,28011,"Bolivar County, Mississippi",Bolivar County, Mississippi,18871,7796,3140,4656,280,12,4,8,0,0,0,0,667,24,7,17,216,0,0,0,46,38,38,0,496,24,7,17
1410,9147,1379,572,807,0500000US28013,28013,"Calhoun County, Mississippi",Calhoun County, Mississippi,4037,1023,380,643,137,71,39,32,0,0,0,0,865,242,130,112,32,0,0,0,0,0,0,0,757,189,108,81
1411,6310,670,292,378,0500000US28015,28015,"Carroll County, Mississippi",Carroll County, Mississippi,3365,833,450,383,15,15,9,6,0,0,0,0,9,4,0,4,0,0,0,0,0,0,0,0,0,0,0,0
1412,8203,1097,554,543,0500000US28017,28017,"Chickasaw County, Mississippi",Chickasaw County, Mississippi,7211,2403,890,1513,274,2,0,2,0,0,0,0,789,25,0,25,14,0,0,0,21,0,0,0,658,0,0,0
1413,5438,568,262,306,0500000US28019,28019,"Choctaw County, Mississippi",Choctaw County, Mississippi,2506,857,415,442,48,4,0,4,6,6,0,6,39,1,1,0,2,1,1,0,30,0,0,0,0,0,0,0
1414,970,58,47,11,0500000US28021,28021,"Claiborne County, Mississippi",Claiborne County, Mississippi,7167,2819,1210,1609,23,0,0,0,0,0,0,0,4,1,0,1,62,0,0,0,0,0,0,0,1,1,0,1
1415,9766,946,368,578,0500000US28023,28023,"Clarke County, Mississippi",Clarke County, Mississippi,5567,2122,688,1434,28,0,0,0,0,0,0,0,128,0,0,0,0,0,0,0,0,0,0,0,23,0,0,0
1416,7385,657,242,415,0500000US28025,28025,"Clay County, Mississippi",Clay County, Mississippi,11475,4051,1551,2500,155,3,1,2,0,0,0,0,16,1,1,0,106,76,52,24,109,20,0,20,0,0,0,0
1417,4393,486,211,275,0500000US28027,28027,"Coahoma County, Mississippi",Coahoma County, Mississippi,17132,7373,3134,4239,181,52,37,15,0,0,0,0,317,98,37,61,109,101,51,50,75,31,23,8,124,11,0,11
1418,12010,1375,615,760,0500000US28029,28029,"Copiah County, Mississippi",Copiah County, Mississippi,14118,4159,1676,2483,487,146,6,140,0,0,0,0,913,311,48,263,45,29,29,0,0,0,0,0,490,173,42,131
1419,11170,1414,575,839,0500000US28031,28031,"Covington County, Mississippi",Covington County, Mississippi,6891,2948,1174,1774,83,0,0,0,0,0,0,0,440,197,156,41,5,0,0,0,67,67,67,0,0,0,0,0
1420,113543,8483,3279,5204,0500000US28033,28033,"DeSoto County, Mississippi",DeSoto County, Mississippi,51619,7007,2847,4160,4352,484,137,347,11,0,0,0,9047,1362,710,652,2732,94,59,35,281,54,14,40,3996,715,386,329
1421,40875,7166,2886,4280,0500000US28035,28035,"Forrest County, Mississippi",Forrest County, Mississippi,26468,9553,3595,5958,1558,532,397,135,8,8,0,8,2164,803,549,254,592,271,212,59,208,78,56,22,289,147,129,18
1422,4801,622,279,343,0500000US28037,28037,"Franklin County, Mississippi",Franklin County, Mississippi,2669,714,286,428,146,134,94,40,0,0,0,0,1,0,0,0,2,0,0,0,11,0,0,0,1,0,0,0
1423,20704,3138,1419,1719,0500000US28039,28039,"George County, Mississippi",George County, Mississippi,1590,646,356,290,288,79,29,50,0,0,0,0,687,283,224,59,214,0,0,0,98,0,0,0,59,32,32,0
1424,8066,992,440,552,0500000US28041,28041,"Greene County, Mississippi",Greene County, Mississippi,1408,560,210,350,32,0,0,0,0,0,0,0,26,16,16,0,1,0,0,0,7,5,0,5,3,0,0,0
1425,11092,1633,741,892,0500000US28043,28043,"Grenada County, Mississippi",Grenada County, Mississippi,9031,3365,1452,1913,196,3,0,3,0,0,0,0,172,0,0,0,57,0,0,0,73,63,52,11,77,0,0,0
1426,39938,4598,2013,2585,0500000US28045,28045,"Hancock County, Mississippi",Hancock County, Mississippi,3662,1393,463,930,1395,72,27,45,0,0,0,0,1762,228,130,98,468,0,0,0,301,97,97,0,202,130,130,0
1427,127339,15032,6064,8968,0500000US28047,28047,"Harrison County, Mississippi",Harrison County, Mississippi,50105,16354,7244,9110,8425,2142,836,1306,138,41,0,41,10685,2588,1018,1570,5119,807,268,539,905,61,61,0,1881,315,117,198
1428,54517,4804,2056,2748,0500000US28049,28049,"Hinds County, Mississippi",Hinds County, Mississippi,165874,40218,17463,22755,2036,433,248,185,63,0,0,0,3455,507,304,203,1640,270,210,60,241,35,3,32,1015,237,161,76
1429,2328,263,100,163,0500000US28051,28051,"Holmes County, Mississippi",Holmes County, Mississippi,14229,6402,2990,3412,71,0,0,0,0,0,0,0,79,0,0,0,19,0,0,0,0,0,0,0,43,43,18,25
1430,1617,213,61,152,0500000US28053,28053,"Humphreys County, Mississippi",Humphreys County, Mississippi,6384,2668,1079,1589,27,11,1,10,12,0,0,0,63,0,0,0,14,8,6,2,5,0,0,0,48,0,0,0
1431,395,84,46,38,0500000US28055,28055,"Issaquena County, Mississippi",Issaquena County, Mississippi,505,160,93,67,1,1,1,0,0,0,0,0,10,10,10,0,0,0,0,0,0,0,0,0,0,0,0,0
1432,20080,2161,873,1288,0500000US28057,28057,"Itawamba County, Mississippi",Itawamba County, Mississippi,1258,179,81,98,213,5,5,0,0,0,0,0,360,84,23,61,0,0,0,0,64,39,39,0,113,16,16,0
1433,95272,10459,4714,5745,0500000US28059,28059,"Jackson County, Mississippi",Jackson County, Mississippi,29663,8622,3252,5370,3544,967,628,339,185,0,0,0,9562,1982,1004,978,3326,79,38,41,655,179,108,71,4192,786,363,423
1434,7219,806,423,383,0500000US28061,28061,"Jasper County, Mississippi",Jasper County, Mississippi,8894,2552,1306,1246,94,12,2,10,0,0,0,0,79,0,0,0,0,0,0,0,0,0,0,0,106,106,38,68
1435,801,147,42,105,0500000US28063,28063,"Jefferson County, Mississippi",Jefferson County, Mississippi,5746,1701,775,926,0,0,0,0,0,0,0,0,290,34,0,34,41,0,0,0,11,0,0,0,0,0,0,0
1436,4148,633,309,324,0500000US28065,28065,"Jefferson Davis County, Mississippi",Jefferson Davis County, Mississippi,6700,1846,799,1047,60,13,0,13,0,0,0,0,66,0,0,0,17,0,0,0,0,0,0,0,12,0,0,0
1437,43179,4835,1868,2967,0500000US28067,28067,"Jones County, Mississippi",Jones County, Mississippi,19523,7967,3251,4716,581,196,119,77,36,0,0,0,3083,1423,532,891,248,67,60,7,228,120,0,120,434,266,118,148
1438,3036,331,45,286,0500000US28069,28069,"Kemper County, Mississippi",Kemper County, Mississippi,5509,1905,713,1192,26,0,0,0,0,0,0,0,0,0,0,0,0,0,0,0,343,175,78,97,0,0,0,0
1439,34189,6556,3293,3263,0500000US28071,28071,"Lafayette County, Mississippi",Lafayette County, Mississippi,12232,4096,1945,2151,526,8,0,8,0,0,0,0,1270,436,233,203,1046,158,111,47,166,0,0,0,660,267,58,209
1440,45846,5815,2335,3480,0500000US28073,28073,"Lamar County, Mississippi",Lamar County, Mississippi,12582,4363,2001,2362,1000,81,41,40,0,0,0,0,1789,597,254,343,882,309,215,94,78,62,0,62,469,130,28,102
1441,37860,3379,1153,2226,0500000US28075,28075,"Lauderdale County, Mississippi",Lauderdale County, Mississippi,31350,12364,5087,7277,756,66,15,51,0,0,0,0,1648,427,162,265,533,169,90,79,99,28,0,28,469,44,11,33
1442,8116,1236,551,685,0500000US28077,28077,"Lawrence County, Mississippi",Lawrence County, Mississippi,4137,1072,457,615,136,13,7,6,0,0,0,0,102,101,47,54,32,5,0,5,26,0,0,0,120,120,38,82
1443,10449,1354,579,775,0500000US28079,28079,"Leake County, Mississippi",Leake County, Mississippi,9239,2766,1326,1440,146,21,6,15,0,0,0,0,1075,831,489,342,68,0,0,0,1254,571,240,331,344,297,83,214
1444,54586,4241,1650,2591,0500000US28081,28081,"Lee County, Mississippi",Lee County, Mississippi,24732,6462,2771,3691,1265,284,182,102,202,0,0,0,2332,270,145,125,798,214,141,73,134,14,14,0,1123,167,121,46
1445,6114,343,162,181,0500000US28083,28083,"Leflore County, Mississippi",Leflore County, Mississippi,20405,7995,3107,4888,218,42,8,34,0,0,0,0,766,119,16,103,171,103,66,37,0,0,0,0,517,100,16,84
1446,22564,3991,1775,2216,0500000US28085,28085,"Lincoln County, Mississippi",Lincoln County, Mississippi,10462,3343,1359,1984,43,0,0,0,0,0,0,0,416,87,0,87,180,0,0,0,0,0,0,0,1,0,0,0
1447,29209,2106,885,1221,0500000US28087,28087,"Lowndes County, Mississippi",Lowndes County, Mississippi,24908,8687,3479,5208,1256,158,102,56,0,0,0,0,1145,171,50,121,561,0,0,0,116,11,4,7,318,52,52,0
1448,57655,2898,1061,1837,0500000US28089,28089,"Madison County, Mississippi",Madison County, Mississippi,38879,7010,2959,4051,1190,388,226,162,0,0,0,0,3127,622,240,382,2815,180,93,87,103,0,0,0,1288,12,0,12
1449,15534,2777,1137,1640,0500000US28091,28091,"Marion County, Mississippi",Marion County, Mississippi,7634,3131,1195,1936,164,93,6,87,24,0,0,0,391,78,68,10,175,0,0,0,0,0,0,0,398,78,68,10
1450,16263,2176,1013,1163,0500000US28093,28093,"Marshall County, Mississippi",Marshall County, Mississippi,15227,4249,1948,2301,349,203,81,122,0,0,0,0,1349,676,273,403,0,0,0,0,40,40,21,19,644,90,42,48
1451,23387,2931,1317,1614,0500000US28095,28095,"Monroe County, Mississippi",Monroe County, Mississippi,10430,2949,1024,1925,316,167,167,0,0,0,0,0,456,0,0,0,122,0,0,0,7,0,0,0,0,0,0,0
1452,5079,935,300,635,0500000US28097,28097,"Montgomery County, Mississippi",Montgomery County, Mississippi,4395,1940,575,1365,175,15,0,15,0,0,0,0,94,0,0,0,0,0,0,0,0,0,0,0,76,0,0,0
1453,16603,2717,1034,1683,0500000US28099,28099,"Neshoba County, Mississippi",Neshoba County, Mississippi,6124,2190,915,1275,364,8,0,8,10,10,10,0,662,27,0,27,159,12,6,6,4818,1837,1007,830,65,0,0,0
1454,12411,1962,765,1197,0500000US28101,28101,"Newton County, Mississippi",Newton County, Mississippi,6214,1797,734,1063,320,64,11,53,0,0,0,0,403,99,39,60,108,0,0,0,1109,672,236,436,276,153,116,37
1455,2623,100,55,45,0500000US28103,28103,"Noxubee County, Mississippi",Noxubee County, Mississippi,7527,2850,1266,1584,58,0,0,0,0,0,0,0,138,63,31,32,11,0,0,0,0,0,0,0,0,0,0,0
1456,24851,6685,3876,2809,0500000US28105,28105,"Oktibbeha County, Mississippi",Oktibbeha County, Mississippi,17078,5270,2031,3239,857,180,97,83,81,0,0,0,726,265,150,115,1573,627,351,276,55,45,0,45,201,37,0,37
1457,15677,1681,747,934,0500000US28107,28107,"Panola County, Mississippi",Panola County, Mississippi,16327,4741,2486,2255,705,14,9,5,145,0,0,0,658,209,63,146,138,0,0,0,130,0,0,0,41,41,0,41
1458,43957,5293,2251,3042,0500000US28109,28109,"Pearl River County, Mississippi",Pearl River County, Mississippi,6715,1933,798,1135,1371,420,255,165,1,0,0,0,1783,198,51,147,184,67,67,0,397,0,0,0,295,64,21,43
1459,9206,1562,570,992,0500000US28111,28111,"Perry County, Mississippi",Perry County, Mississippi,2022,560,262,298,303,4,0,4,0,0,0,0,187,96,28,68,141,0,0,0,0,0,0,0,0,0,0,0
1460,16369,2955,1141,1814,0500000US28113,28113,"Pike County, Mississippi",Pike County, Mississippi,20769,8625,3942,4683,296,123,0,123,0,0,0,0,603,330,127,203,278,134,95,39,171,63,32,31,241,81,30,51
1461,24176,2768,1217,1551,0500000US28115,28115,"Pontotoc County, Mississippi",Pontotoc County, Mississippi,5036,1179,373,806,561,272,99,173,0,0,0,0,2178,777,225,552,9,0,0,0,0,0,0,0,1644,601,179,422
1462,19858,3664,1265,2399,0500000US28117,28117,"Prentiss County, Mississippi",Prentiss County, Mississippi,2095,451,238,213,991,592,243,349,0,0,0,0,357,161,63,98,622,0,0,0,11,0,0,0,218,37,2,35
1463,1757,334,128,206,0500000US28119,28119,"Quitman County, Mississippi",Quitman County, Mississippi,4994,1964,786,1178,45,26,9,17,0,0,0,0,59,9,9,0,15,0,0,0,0,0,0,0,0,0,0,0
1464,110772,8085,2880,5205,0500000US28121,28121,"Rankin County, Mississippi",Rankin County, Mississippi,30019,4100,1897,2203,2374,339,82,257,0,0,0,0,4092,560,239,321,1721,50,23,27,161,17,17,0,1680,501,395,106
1465,13753,2080,829,1251,0500000US28123,28123,"Scott County, Mississippi",Scott County, Mississippi,10557,3771,1836,1935,415,52,52,0,0,0,0,0,3144,982,656,326,73,0,0,0,47,0,0,0,1198,335,203,132
1466,1043,35,0,35,0500000US28125,28125,"Sharkey County, Mississippi",Sharkey County, Mississippi,3242,996,440,556,16,0,0,0,13,13,13,0,17,13,13,0,0,0,0,0,6,0,0,0,4,0,0,0
1467,16137,2036,849,1187,0500000US28127,28127,"Simpson County, Mississippi",Simpson County, Mississippi,9717,2986,1275,1711,169,5,1,4,0,0,0,0,63,3,0,3,135,0,0,0,24,0,0,0,0,0,0,0
1468,11672,1436,590,846,0500000US28129,28129,"Smith County, Mississippi",Smith County, Mississippi,3799,1071,504,567,54,10,10,0,50,50,0,50,133,11,0,11,87,0,0,0,0,0,0,0,10,7,7,0
1469,13524,2015,848,1167,0500000US28131,28131,"Stone County, Mississippi",Stone County, Mississippi,2967,685,277,408,615,215,95,120,18,18,18,0,352,40,32,8,0,0,0,0,23,0,0,0,0,0,0,0
1470,4942,327,220,107,0500000US28133,28133,"Sunflower County, Mississippi",Sunflower County, Mississippi,15958,6042,2507,3535,210,155,1,154,0,0,0,0,473,153,20,133,0,0,0,0,37,12,0,12,99,28,28,0
1471,4661,597,273,324,0500000US28135,28135,"Tallahatchie County, Mississippi",Tallahatchie County, Mississippi,7872,2771,1370,1401,34,0,0,0,0,0,0,0,0,0,0,0,26,0,0,0,9,8,8,0,0,0,0,0
1472,17452,1780,728,1052,0500000US28137,28137,"Tate County, Mississippi",Tate County, Mississippi,7778,2042,937,1105,538,236,100,136,32,14,0,14,702,228,108,120,44,7,0,7,12,0,0,0,110,0,0,0
1473,16731,3288,1607,1681,0500000US28139,28139,"Tippah County, Mississippi",Tippah County, Mississippi,3569,869,326,543,505,232,31,201,0,0,0,0,1010,447,104,343,46,0,0,0,12,0,0,0,699,153,51,102
1474,17681,3707,1827,1880,0500000US28141,28141,"Tishomingo County, Mississippi",Tishomingo County, Mississippi,474,45,13,32,567,4,1,3,0,0,0,0,627,106,77,29,10,5,5,0,28,0,0,0,27,0,0,0
1475,1767,122,20,102,0500000US28143,28143,"Tunica County, Mississippi",Tunica County, Mississippi,7751,2870,1277,1593,49,37,37,0,0,0,0,0,95,56,37,19,0,0,0,0,0,0,0,0,28,19,0,19
1476,21993,2095,722,1373,0500000US28145,28145,"Union County, Mississippi",Union County, Mississippi,4629,890,560,330,318,6,0,6,0,0,0,0,1219,157,70,87,82,0,0,0,62,0,0,0,955,110,60,50
1477,7444,1074,438,636,0500000US28147,28147,"Walthall County, Mississippi",Walthall County, Mississippi,6433,1581,622,959,80,28,21,7,0,0,0,0,297,84,49,35,9,0,0,0,0,0,0,0,191,67,32,35
1478,21253,1331,474,857,0500000US28149,28149,"Warren County, Mississippi",Warren County, Mississippi,22439,7767,3157,4610,698,172,80,92,9,0,0,0,970,227,185,42,307,11,11,0,99,0,0,0,226,124,92,32
1479,10988,1280,504,776,0500000US28151,28151,"Washington County, Mississippi",Washington County, Mississippi,31993,12275,5452,6823,505,52,8,44,0,0,0,0,728,218,152,66,306,5,0,5,18,0,0,0,468,45,45,0
1480,11550,1366,516,850,0500000US28153,28153,"Wayne County, Mississippi",Wayne County, Mississippi,8233,2841,1260,1581,264,0,0,0,0,0,0,0,328,81,23,58,44,0,0,0,0,0,0,0,95,81,23,58
1481,7535,1032,569,463,0500000US28155,28155,"Webster County, Mississippi",Webster County, Mississippi,1867,632,268,364,18,10,5,5,0,0,0,0,134,47,39,8,26,0,0,0,21,0,0,0,33,0,0,0
1482,2136,227,99,128,0500000US28157,28157,"Wilkinson County, Mississippi",Wilkinson County, Mississippi,5185,1851,830,1021,64,22,0,22,0,0,0,0,50,12,0,12,2,0,0,0,0,0,0,0,108,0,0,0
1483,8797,1171,499,672,0500000US28159,28159,"Winston County, Mississippi",Winston County, Mississippi,8301,2908,1108,1800,211,39,10,29,0,0,0,0,223,40,21,19,6,0,0,0,178,96,26,70,60,0,0,0
1484,6996,893,408,485,0500000US28161,28161,"Yalobusha County, Mississippi",Yalobusha County, Mississippi,4709,1603,855,748,84,20,9,11,0,0,0,0,285,0,0,0,0,0,0,0,0,0,0,0,16,0,0,0
1485,8355,1112,424,688,0500000US28163,28163,"Yazoo County, Mississippi",Yazoo County, Mississippi,13535,5475,2389,3086,407,252,120,132,0,0,0,0,946,799,290,509,1,1,0,1,18,0,0,0,441,441,217,224
1486,20550,4788,2131,2657,0500000US29001,29001,"Adair County, Missouri",Adair County, Missouri,757,41,12,29,498,56,17,39,6,0,0,0,570,71,0,71,557,291,118,173,42,5,5,0,96,0,0,0
1487,16355,1211,437,774,0500000US29003,29003,"Andrew County, Missouri",Andrew County, Missouri,171,2,0,2,367,105,50,55,95,0,0,0,446,24,3,21,150,0,0,0,29,4,4,0,20,0,0,0
1488,4902,548,169,379,0500000US29005,29005,"Atchison County, Missouri",Atchison County, Missouri,16,3,3,0,59,4,2,2,0,0,0,0,75,18,8,10,4,0,0,0,48,0,0,0,15,8,6,2
1489,20701,2881,1246,1635,0500000US29007,29007,"Audrain County, Missouri",Audrain County, Missouri,1178,134,43,91,885,175,105,70,16,0,0,0,782,317,218,99,5,0,0,0,80,40,28,12,130,24,24,0
1490,29379,4996,2004,2992,0500000US29009,29009,"Barry County, Missouri",Barry County, Missouri,57,0,0,0,1892,383,174,209,0,0,0,0,3340,1134,583,551,619,0,0,0,272,45,35,10,786,209,91,118
1491,10661,2080,891,1189,0500000US29011,29011,"Barton County, Missouri",Barton County, Missouri,4,0,0,0,483,208,118,90,7,7,0,7,325,189,98,91,4,0,0,0,269,78,51,27,86,5,0,5
1492,14869,2081,851,1230,0500000US29013,29013,"Bates County, Missouri",Bates County, Missouri,277,63,37,26,251,50,29,21,9,0,0,0,384,106,21,85,46,0,0,0,120,35,24,11,150,100,21,79
1493,18004,3150,1702,1448,0500000US29015,29015,"Benton County, Missouri",Benton County, Missouri,69,9,7,2,461,180,60,120,0,0,0,0,401,121,6,115,14,0,0,0,259,106,11,95,30,0,0,0
1494,11539,1771,718,1053,0500000US29017,29017,"Bollinger County, Missouri",Bollinger County, Missouri,53,23,8,15,183,102,86,16,0,0,0,0,170,0,0,0,0,0,0,0,92,0,0,0,56,0,0,0
1495,133153,17953,8228,9725,0500000US29019,29019,"Boone County, Missouri",Boone County, Missouri,15372,5678,2166,3512,8325,1717,967,750,130,100,69,31,5965,1657,713,944,7780,1599,967,632,646,110,68,42,1670,758,395,363
1496,69735,9411,3978,5433,0500000US29021,29021,"Buchanan County, Missouri",Buchanan County, Missouri,3583,1357,758,599,3961,924,411,513,513,426,125,301,5568,1003,489,514,1150,105,101,4,334,90,0,90,1809,215,139,76
1497,36974,7536,2980,4556,0500000US29023,29023,"Butler County, Missouri",Butler County, Missouri,1935,754,339,415,1378,485,231,254,31,0,0,0,843,222,143,79,377,44,41,3,287,128,64,64,85,37,11,26
1498,8269,1297,574,723,0500000US29025,29025,"Caldwell County, Missouri",Caldwell County, Missouri,28,5,5,0,239,25,3,22,0,0,0,0,208,23,3,20,42,0,0,0,42,29,26,3,21,0,0,0
1499,37012,3253,1332,1921,0500000US29027,29027,"Callaway County, Missouri",Callaway County, Missouri,1219,327,127,200,849,147,62,85,194,137,97,40,884,28,14,14,346,73,68,5,262,9,9,0,176,0,0,0
1500,42438,6020,2722,3298,0500000US29029,29029,"Camden County, Missouri",Camden County, Missouri,287,73,44,29,798,209,117,92,0,0,0,0,1235,255,152,103,147,0,0,0,197,9,7,2,402,161,117,44
1501,64873,8207,3796,4411,0500000US29031,29031,"Cape Girardeau County, Missouri",Cape Girardeau County, Missouri,5272,1909,860,1049,2241,547,235,312,104,9,2,7,1850,580,218,362,1316,705,464,241,73,0,0,0,317,38,15,23
1502,8136,1056,420,636,0500000US29033,29033,"Carroll County, Missouri",Carroll County, Missouri,92,1,1,0,256,3,0,3,0,0,0,0,145,26,14,12,21,2,2,0,7,7,7,0,14,6,6,0
1503,5596,1016,398,618,0500000US29035,29035,"Carter County, Missouri",Carter County, Missouri,3,3,3,0,43,29,29,0,0,0,0,0,305,54,54,0,0,0,0,0,236,0,0,0,0,0,0,0
1504,90311,6545,2477,4068,0500000US29037,29037,"Cass County, Missouri",Cass County, Missouri,4275,931,694,237,3657,540,187,353,104,16,0,16,4773,432,267,165,626,132,19,113,482,29,8,21,823,14,0,14
1505,13163,2344,1284,1060,0500000US29039,29039,"Cedar County, Missouri",Cedar County, Missouri,13,13,5,8,379,110,97,13,0,0,0,0,319,10,9,1,30,0,0,0,53,53,53,0,70,22,0,22
1506,6795,784,376,408,0500000US29041,29041,"Chariton County, Missouri",Chariton County, Missouri,148,74,39,35,149,50,40,10,0,0,0,0,69,0,0,0,0,0,0,0,5,0,0,0,74,46,0,46
1507,80146,8123,3676,4447,0500000US29043,29043,"Christian County, Missouri",Christian County, Missouri,938,99,71,28,2604,176,63,113,24,0,0,0,2704,174,134,40,527,24,2,22,383,59,37,22,378,0,0,0
1508,6458,769,353,416,0500000US29045,29045,"Clark County, Missouri",Clark County, Missouri,18,0,0,0,80,12,10,2,0,0,0,0,53,8,0,8,89,35,20,15,11,11,8,3,20,0,0,0
1509,195728,12475,5269,7206,0500000US29047,29047,"Clay County, Missouri",Clay County, Missouri,14836,3067,1491,1576,11782,1514,564,950,817,186,90,96,17063,2283,1085,1198,5496,554,248,306,1017,125,116,9,4558,662,354,308
1510,18579,1996,901,1095,0500000US29049,29049,"Clinton County, Missouri",Clinton County, Missouri,277,35,0,35,408,20,3,17,8,0,0,0,467,0,0,0,112,0,0,0,74,6,0,6,20,0,0,0
1511,59804,4363,1606,2757,0500000US29051,29051,"Cole County, Missouri",Cole County, Missouri,7175,1807,739,1068,1568,422,203,219,18,0,0,0,2049,289,144,145,1154,18,16,2,236,29,24,5,108,18,9,9
1512,14372,1753,826,927,0500000US29053,29053,"Cooper County, Missouri",Cooper County, Missouri,510,80,43,37,709,125,52,73,36,0,0,0,331,85,7,78,60,7,7,0,83,34,7,27,59,0,0,0
1513,22311,3972,1854,2118,0500000US29055,29055,"Crawford County, Missouri",Crawford County, Missouri,104,101,52,49,406,58,13,45,116,0,0,0,474,36,16,20,73,8,8,0,11,0,0,0,166,0,0,0
1514,6941,1330,701,629,0500000US29057,29057,"Dade County, Missouri",Dade County, Missouri,20,10,4,6,238,37,3,34,6,0,0,0,167,68,10,58,38,0,0,0,53,9,5,4,21,4,0,4
1515,15647,2910,1244,1666,0500000US29059,29059,"Dallas County, Missouri",Dallas County, Missouri,16,2,2,0,324,17,14,3,0,0,0,0,357,156,24,132,108,48,0,48,170,92,28,64,29,3,1,2
1516,7774,1042,438,604,0500000US29061,29061,"Daviess County, Missouri",Daviess County, Missouri,17,3,1,2,127,23,14,9,10,0,0,0,136,2,2,0,11,0,0,0,17,11,0,11,56,0,0,0
1517,8473,771,333,438,0500000US29063,29063,"DeKalb County, Missouri",DeKalb County, Missouri,19,8,3,5,56,7,1,6,7,0,0,0,137,32,2,30,56,21,2,19,42,10,1,9,6,6,6,0
1518,14313,2394,1009,1385,0500000US29065,29065,"Dent County, Missouri",Dent County, Missouri,81,69,36,33,517,211,89,122,0,0,0,0,264,77,37,40,91,24,24,0,124,45,0,45,94,0,0,0
1519,12466,1955,866,1089,0500000US29067,29067,"Douglas County, Missouri",Douglas County, Missouri,41,0,0,0,83,28,18,10,0,0,0,0,286,0,0,0,16,0,0,0,255,0,0,0,197,0,0,0
1520,22858,4857,2236,2621,0500000US29069,29069,"Dunklin County, Missouri",Dunklin County, Missouri,2924,997,499,498,1164,139,77,62,14,0,0,0,1999,821,281,540,138,11,0,11,27,25,10,15,630,361,111,250
1521,96803,9044,3641,5403,0500000US29071,29071,"Franklin County, Missouri",Franklin County, Missouri,718,199,182,17,2426,301,159,142,13,0,0,0,1805,216,126,90,523,0,0,0,229,47,6,41,476,50,42,8
1522,13771,1352,670,682,0500000US29073,29073,"Gasconade County, Missouri",Gasconade County, Missouri,84,0,0,0,248,8,8,0,0,0,0,0,87,0,0,0,133,9,0,9,53,0,0,0,24,0,0,0
1523,6141,877,413,464,0500000US29075,29075,"Gentry County, Missouri",Gentry County, Missouri,36,23,19,4,76,7,0,7,3,0,0,0,114,28,17,11,36,5,0,5,17,0,0,0,26,0,0,0
1524,243459,34413,15862,18551,0500000US29077,29077,"Greene County, Missouri",Greene County, Missouri,7885,2348,1133,1215,11858,2546,1323,1223,83,8,0,8,10600,2529,1155,1374,5696,1195,424,771,1333,154,95,59,2983,709,295,414
1525,8999,1468,588,880,0500000US29079,29079,"Grundy County, Missouri",Grundy County, Missouri,7,3,3,0,261,110,54,56,1,1,0,1,239,21,13,8,113,9,9,0,48,2,0,2,25,0,0,0
1526,7834,1420,649,771,0500000US29081,29081,"Harrison County, Missouri",Harrison County, Missouri,45,29,2,27,141,53,21,32,3,0,0,0,204,59,39,20,20,0,0,0,35,11,0,11,12,0,0,0
1527,20152,3231,1379,1852,0500000US29083,29083,"Henry County, Missouri",Henry County, Missouri,243,107,95,12,506,124,77,47,1,0,0,0,551,293,158,135,118,24,0,24,44,3,2,1,41,38,38,0
1528,8844,1169,515,654,0500000US29085,29085,"Hickory County, Missouri",Hickory County, Missouri,1,1,0,1,145,71,10,61,0,0,0,0,169,6,6,0,45,18,0,18,144,26,11,15,40,0,0,0
1529,4091,392,189,203,0500000US29087,29087,"Holt County, Missouri",Holt County, Missouri,16,0,0,0,17,6,4,2,2,0,0,0,45,7,7,0,41,11,1,10,43,7,0,7,0,0,0,0
1530,8223,912,423,489,0500000US29089,29089,"Howard County, Missouri",Howard County, Missouri,538,60,36,24,322,87,34,53,0,0,0,0,166,35,35,0,36,2,0,2,63,23,23,0,34,0,0,0
1531,37144,8358,3350,5008,0500000US29091,29091,"Howell County, Missouri",Howell County, Missouri,94,37,0,37,801,235,171,64,0,0,0,0,865,342,162,180,279,223,32,191,453,293,184,109,85,21,10,11
1532,9255,2106,928,1178,0500000US29093,29093,"Iron County, Missouri",Iron County, Missouri,18,4,2,2,295,40,22,18,0,0,0,0,178,14,11,3,48,3,0,3,41,0,0,0,0,0,0,0
1533,425710,36888,16356,20532,0500000US29095,29095,"Jackson County, Missouri",Jackson County, Missouri,159800,36974,15734,21240,29603,4649,2054,2595,2397,309,129,180,63688,13236,5889,7347,12706,2353,1224,1129,2148,486,335,151,26546,6862,3117,3745
1534,99215,15866,7279,8587,0500000US29097,29097,"Jasper County, Missouri",Jasper County, Missouri,2051,517,245,272,5337,1377,769,608,332,13,0,13,9818,3086,1354,1732,1374,184,132,52,1479,234,121,113,2066,525,190,335
1535,205543,17978,7787,10191,0500000US29099,29099,"Jefferson County, Missouri",Jefferson County, Missouri,1813,495,332,163,7920,1223,518,705,35,0,0,0,4508,343,220,123,1733,58,7,51,538,83,34,49,526,51,25,26
1536,42225,5148,2165,2983,0500000US29101,29101,"Johnson County, Missouri",Johnson County, Missouri,1558,377,196,181,2392,439,172,267,164,49,29,20,2374,254,76,178,1121,381,219,162,107,0,0,0,301,68,12,56
1537,3736,591,221,370,0500000US29103,29103,"Knox County, Missouri",Knox County, Missouri,19,9,9,0,83,2,2,0,2,0,0,0,35,7,0,7,26,0,0,0,0,0,0,0,6,0,0,0
1538,32449,4460,1680,2780,0500000US29105,29105,"Laclede County, Missouri",Laclede County, Missouri,170,46,0,46,1378,310,98,212,12,0,0,0,908,424,80,344,140,17,0,17,218,15,12,3,184,12,4,8
1539,29526,3046,1259,1787,0500000US29107,29107,"Lafayette County, Missouri",Lafayette County, Missouri,712,85,75,10,527,156,152,4,68,0,0,0,985,440,292,148,221,60,26,34,59,28,16,12,384,165,114,51
1540,33339,4995,1884,3111,0500000US29109,29109,"Lawrence County, Missouri",Lawrence County, Missouri,83,3,3,0,1178,198,82,116,0,0,0,0,2911,1225,560,665,27,0,0,0,256,103,24,79,603,369,210,159
1541,8546,1661,770,891,0500000US29111,29111,"Lewis County, Missouri",Lewis County, Missouri,303,44,22,22,186,15,4,11,26,0,0,0,55,4,0,4,0,0,0,0,59,2,0,2,0,0,0,0
1542,52732,5491,2379,3112,0500000US29113,29113,"Lincoln County, Missouri",Lincoln County, Missouri,1194,384,169,215,1417,189,88,101,12,12,12,0,1448,133,0,133,156,22,2,20,111,0,0,0,261,63,21,42
1543,11217,1604,663,941,0500000US29115,29115,"Linn County, Missouri",Linn County, Missouri,72,39,15,24,199,94,45,49,7,0,0,0,306,136,69,67,43,9,4,5,26,10,0,10,17,0,0,0
1544,12804,1485,536,949,0500000US29117,29117,"Livingston County, Missouri",Livingston County, Missouri,307,57,27,30,321,85,13,72,5,1,1,0,258,11,0,11,96,26,7,19,45,4,3,1,32,0,0,0
1545,16389,2731,1208,1523,0500000US29119,29119,"McDonald County, Missouri",McDonald County, Missouri,400,69,37,32,1641,239,151,88,560,248,122,126,2626,730,429,301,349,108,75,33,711,187,145,42,580,107,72,35
1546,13836,1498,652,846,0500000US29121,29121,"Macon County, Missouri",Macon County, Missouri,332,51,10,41,368,158,127,31,4,4,0,4,233,21,18,3,112,88,78,10,94,51,31,20,27,0,0,0
1547,11229,1461,626,835,0500000US29123,29123,"Madison County, Missouri",Madison County, Missouri,42,3,3,0,251,111,40,71,0,0,0,0,286,123,52,71,42,0,0,0,29,0,0,0,39,0,0,0
1548,8322,1467,684,783,0500000US29125,29125,"Maries County, Missouri",Maries County, Missouri,7,6,0,6,37,24,7,17,0,0,0,0,291,26,0,26,29,9,0,9,25,0,0,0,12,0,0,0
1549,24451,3611,1568,2043,0500000US29127,29127,"Marion County, Missouri",Marion County, Missouri,1138,319,143,176,816,344,158,186,41,7,0,7,461,281,134,147,147,41,0,41,58,34,22,12,55,0,0,0
1550,3349,423,181,242,0500000US29129,29129,"Mercer County, Missouri",Mercer County, Missouri,7,3,2,1,114,5,5,0,0,0,0,0,93,0,0,0,19,0,0,0,0,0,0,0,10,0,0,0
1551,23651,3055,1479,1576,0500000US29131,29131,"Miller County, Missouri",Miller County, Missouri,95,37,35,2,376,117,14,103,14,14,14,0,499,114,52,62,217,0,0,0,88,60,46,14,36,0,0,0
1552,8678,1475,661,814,0500000US29133,29133,"Mississippi County, Missouri",Mississippi County, Missouri,2520,1169,568,601,156,14,14,0,0,0,0,0,285,89,7,82,5,0,0,0,0,0,0,0,0,0,0,0
1553,13259,1334,553,781,0500000US29135,29135,"Moniteau County, Missouri",Moniteau County, Missouri,167,107,107,0,182,1,0,1,0,0,0,0,733,112,49,63,35,0,0,0,129,0,0,0,94,0,0,0
1554,7863,1107,483,624,0500000US29137,29137,"Monroe County, Missouri",Monroe County, Missouri,255,74,42,32,129,41,7,34,12,12,0,12,146,36,4,32,44,25,10,15,61,44,31,13,24,0,0,0
1555,10308,1442,658,784,0500000US29139,29139,"Montgomery County, Missouri",Montgomery County, Missouri,157,87,4,83,316,87,61,26,1,1,0,1,243,16,0,16,10,5,5,0,3,3,0,3,144,0,0,0
1556,18875,3681,1491,2190,0500000US29141,29141,"Morgan County, Missouri",Morgan County, Missouri,160,33,0,33,424,33,15,18,0,0,0,0,461,32,13,19,180,0,0,0,75,75,38,37,40,0,0,0
1557,13351,2329,941,1388,0500000US29143,29143,"New Madrid County, Missouri",New Madrid County, Missouri,2679,921,388,533,516,115,26,89,0,0,0,0,332,119,51,68,0,0,0,0,21,19,11,8,0,0,0,0
1558,47901,5767,2687,3080,0500000US29145,29145,"Newton County, Missouri",Newton County, Missouri,528,237,118,119,3779,653,142,511,641,154,84,70,3181,969,481,488,796,30,0,30,1111,184,100,84,391,126,54,72
1559,17938,3493,1743,1750,0500000US29147,29147,"Nodaway County, Missouri",Nodaway County, Missouri,313,105,91,14,270,87,34,53,24,0,0,0,312,176,99,77,233,94,46,48,41,15,2,13,128,63,58,5
1560,9774,2530,1165,1365,0500000US29149,29149,"Oregon County, Missouri",Oregon County, Missouri,0,0,0,0,249,43,22,21,5,0,0,0,196,31,19,12,38,0,0,0,140,131,25,106,40,0,0,0
1561,13018,999,448,551,0500000US29151,29151,"Osage County, Missouri",Osage County, Missouri,6,6,2,4,128,9,3,6,0,0,0,0,117,2,0,2,0,0,0,0,82,73,12,61,20,13,13,0
1562,8575,1927,936,991,0500000US29153,29153,"Ozark County, Missouri",Ozark County, Missouri,8,0,0,0,158,52,20,32,0,0,0,0,167,72,31,41,62,62,0,62,81,49,7,42,32,10,0,10
1563,10926,2202,992,1210,0500000US29155,29155,"Pemiscot County, Missouri",Pemiscot County, Missouri,4373,2285,1002,1283,438,186,81,105,0,0,0,0,435,170,66,104,0,0,0,0,13,0,0,0,157,42,12,30
1564,17899,1602,809,793,0500000US29157,29157,"Perry County, Missouri",Perry County, Missouri,56,21,6,15,428,54,23,31,0,0,0,0,431,25,25,0,193,6,6,0,64,0,0,0,0,0,0,0
1565,35153,4726,2007,2719,0500000US29159,29159,"Pettis County, Missouri",Pettis County, Missouri,1212,440,314,126,1269,225,181,44,27,22,17,5,3729,935,515,420,297,24,1,23,144,0,0,0,1052,209,107,102
1566,36376,6160,3135,3025,0500000US29161,29161,"Phelps County, Missouri",Phelps County, Missouri,682,424,270,154,1796,662,416,246,0,0,0,0,1094,588,318,270,1568,527,408,119,315,60,0,60,98,55,8,47
1567,14797,2401,854,1547,0500000US29163,29163,"Pike County, Missouri",Pike County, Missouri,532,112,21,91,259,76,54,22,0,0,0,0,315,10,0,10,63,13,12,1,4,0,0,0,160,10,0,10
1568,81833,3966,1698,2268,0500000US29165,29165,"Platte County, Missouri",Platte County, Missouri,6725,633,303,330,4202,196,79,117,510,0,0,0,6369,413,166,247,2849,59,11,48,298,20,12,8,1479,104,59,45
1569,28484,4411,2060,2351,0500000US29167,29167,"Polk County, Missouri",Polk County, Missouri,149,35,21,14,933,168,91,77,48,2,0,2,754,22,7,15,83,10,10,0,413,138,113,25,63,4,2,2
1570,31889,3954,2172,1782,0500000US29169,29169,"Pulaski County, Missouri",Pulaski County, Missouri,3591,1062,604,458,2926,934,600,334,218,11,0,11,4143,502,354,148,888,41,26,15,195,79,67,12,892,12,0,12
1571,4442,589,245,344,0500000US29171,29171,"Putnam County, Missouri",Putnam County, Missouri,0,0,0,0,120,50,20,30,0,0,0,0,68,9,0,9,3,3,0,3,0,0,0,0,0,0,0,0
1572,9531,1326,687,639,0500000US29173,29173,"Ralls County, Missouri",Ralls County, Missouri,170,47,47,0,203,37,25,12,0,0,0,0,101,0,0,0,64,12,6,6,49,0,0,0,68,0,0,0
1573,20366,2973,1320,1653,0500000US29175,29175,"Randolph County, Missouri",Randolph County, Missouri,937,254,143,111,706,144,122,22,0,0,0,0,486,129,92,37,143,0,0,0,139,45,9,36,123,28,5,23
1574,21059,2411,999,1412,0500000US29177,29177,"Ray County, Missouri",Ray County, Missouri,242,115,60,55,702,117,5,112,0,0,0,0,585,58,2,56,42,0,0,0,85,0,0,0,78,0,0,0
1575,5719,1033,571,462,0500000US29179,29179,"Reynolds County, Missouri",Reynolds County, Missouri,57,24,24,0,239,16,16,0,10,0,0,0,49,22,0,22,24,0,0,0,10,0,0,0,28,23,5,18
1576,12683,2768,1255,1513,0500000US29181,29181,"Ripley County, Missouri",Ripley County, Missouri,80,45,45,0,194,54,9,45,21,21,21,0,200,132,58,74,77,0,0,0,69,0,0,0,60,60,46,14
1577,338028,13434,5416,8018,0500000US29183,29183,"St. Charles County, Missouri",St. Charles County, Missouri,17453,1938,719,1219,12590,1488,739,749,114,62,22,40,12855,1295,648,647,10131,458,159,299,492,55,55,0,2871,168,68,100
1578,8518,1317,610,707,0500000US29185,29185,"St. Clair County, Missouri",St. Clair County, Missouri,13,3,3,0,285,108,31,77,0,0,0,0,202,70,19,51,17,0,0,0,35,9,4,5,85,0,0,0
1579,16842,1588,694,894,0500000US29186,29186,"Ste. Genevieve County, Missouri",Ste. Genevieve County, Missouri,317,156,11,145,78,58,52,6,0,0,0,0,204,0,0,0,77,0,0,0,21,0,0,0,49,0,0,0
1580,56295,8730,4027,4703,0500000US29187,29187,"St. Francois County, Missouri",St. Francois County, Missouri,935,465,405,60,1285,269,157,112,21,0,0,0,959,120,58,62,260,0,0,0,152,83,11,72,352,26,26,0
1581,632334,35027,14602,20425,0500000US29189,29189,"St. Louis County, Missouri",St. Louis County, Missouri,235782,44795,18791,26004,34479,3418,1842,1576,276,30,6,24,28580,3660,1761,1899,43419,3263,1680,1583,1743,634,151,483,10504,1522,675,847
1582,17274,2230,1016,1214,0500000US29195,29195,"Saline County, Missouri",Saline County, Missouri,989,159,85,74,978,107,37,70,192,23,0,23,2307,764,298,466,176,16,2,14,22,0,0,0,841,609,227,382
1583,4377,714,366,348,0500000US29197,29197,"Schuyler County, Missouri",Schuyler County, Missouri,1,1,0,1,112,0,0,0,0,0,0,0,102,0,0,0,9,0,0,0,0,0,0,0,7,0,0,0
1584,4688,514,287,227,0500000US29199,29199,"Scotland County, Missouri",Scotland County, Missouri,0,0,0,0,101,34,1,33,0,0,0,0,0,0,0,0,2,0,0,0,3,0,0,0,2,0,0,0
1585,31396,4393,1925,2468,0500000US29201,29201,"Scott County, Missouri",Scott County, Missouri,4159,1803,807,996,1151,175,73,102,0,0,0,0,942,305,165,140,145,0,0,0,56,20,20,0,168,0,0,0
1586,7599,1983,847,1136,0500000US29203,29203,"Shannon County, Missouri",Shannon County, Missouri,9,9,0,9,369,80,39,41,0,0,0,0,108,62,9,53,0,0,0,0,11,0,0,0,0,0,0,0
1587,5465,814,387,427,0500000US29205,29205,"Shelby County, Missouri",Shelby County, Missouri,76,8,0,8,75,32,24,8,0,0,0,0,134,20,20,0,8,0,0,0,17,14,0,14,54,0,0,0
1588,27289,4540,1769,2771,0500000US29207,29207,"Stoddard County, Missouri",Stoddard County, Missouri,387,190,78,112,604,165,30,135,0,0,0,0,519,107,32,75,7,7,0,7,0,0,0,0,23,0,0,0
1589,29824,3440,1596,1844,0500000US29209,29209,"Stone County, Missouri",Stone County, Missouri,12,10,6,4,614,189,144,45,0,0,0,0,721,230,57,173,145,11,11,0,146,4,4,0,299,110,40,70
1590,4561,778,450,328,0500000US29211,29211,"Sullivan County, Missouri",Sullivan County, Missouri,146,57,32,25,192,39,7,32,15,15,0,15,1124,125,63,62,3,0,0,0,34,5,5,0,200,66,30,36
1591,47637,6556,2642,3914,0500000US29213,29213,"Taney County, Missouri",Taney County, Missouri,963,478,118,360,1355,317,133,184,11,0,0,0,3313,983,407,576,391,110,39,71,543,105,33,72,1261,457,300,157
1592,22398,5006,2492,2514,0500000US29215,29215,"Texas County, Missouri",Texas County, Missouri,9,9,5,4,588,162,83,79,11,0,0,0,420,120,30,90,467,0,0,0,226,91,11,80,48,0,0,0
1593,18605,2707,1178,1529,0500000US29217,29217,"Vernon County, Missouri",Vernon County, Missouri,38,10,0,10,594,272,209,63,0,0,0,0,400,17,17,0,135,0,0,0,57,0,0,0,22,0,0,0
1594,31417,3718,1690,2028,0500000US29219,29219,"Warren County, Missouri",Warren County, Missouri,606,64,31,33,1220,479,267,212,11,0,0,0,1220,92,13,79,210,115,0,115,198,0,0,0,630,41,13,28
1595,22647,4465,1947,2518,0500000US29221,29221,"Washington County, Missouri",Washington County, Missouri,59,16,0,16,680,177,101,76,35,8,8,0,329,135,36,99,10,0,0,0,49,49,0,49,0,0,0,0
1596,12021,3157,1351,1806,0500000US29223,29223,"Wayne County, Missouri",Wayne County, Missouri,48,12,12,0,379,125,68,57,0,0,0,0,244,56,36,20,89,4,4,0,27,11,0,11,35,0,0,0
1597,35684,5492,2571,2921,0500000US29225,29225,"Webster County, Missouri",Webster County, Missouri,182,7,7,0,1006,386,149,237,11,0,0,0,795,63,44,19,125,0,0,0,141,29,22,7,290,0,0,0
1598,1884,297,140,157,0500000US29227,29227,"Worth County, Missouri",Worth County, Missouri,0,0,0,0,19,14,7,7,0,0,0,0,48,1,0,1,1,0,0,0,1,0,0,0,1,0,0,0
1599,16710,3631,1908,1723,0500000US29229,29229,"Wright County, Missouri",Wright County, Missouri,10,0,0,0,647,18,7,11,0,0,0,0,374,146,8,138,96,0,0,0,59,5,5,0,57,0,0,0
1600,129963,14830,7610,7220,0500000US29510,29510,"St. Louis city, Missouri",St. Louis city, Missouri,136037,38751,16101,22650,9332,1631,555,1076,112,6,0,6,12044,2487,1309,1178,9731,2395,1211,1184,712,157,91,66,3381,1104,499,605
1601,8141,1351,775,576,0500000US30001,30001,"Beaverhead County, Montana",Beaverhead County, Montana,0,0,0,0,235,62,53,9,19,0,0,0,425,27,2,25,2,0,0,0,164,6,6,0,49,4,2,2
1602,3476,413,149,264,0500000US30003,30003,"Big Horn County, Montana",Big Horn County, Montana,0,0,0,0,598,327,227,100,0,0,0,0,771,331,213,118,31,0,0,0,8658,2778,1283,1495,35,0,0,0
1603,2883,476,192,284,0500000US30005,30005,"Blaine County, Montana",Blaine County, Montana,31,29,10,19,104,12,6,6,0,0,0,0,229,89,18,71,6,0,0,0,3455,1372,674,698,55,13,0,13
1604,5714,435,171,264,0500000US30007,30007,"Broadwater County, Montana",Broadwater County, Montana,2,0,0,0,174,0,0,0,0,0,0,0,174,13,13,0,0,0,0,0,46,17,17,0,18,0,0,0
1605,9891,1018,521,497,0500000US30009,30009,"Carbon County, Montana",Carbon County, Montana,58,0,0,0,147,32,6,26,11,0,0,0,267,6,1,5,45,0,0,0,74,27,11,16,98,60,0,60
1606,1232,184,88,96,0500000US30011,30011,"Carter County, Montana",Carter County, Montana,0,0,0,0,32,0,0,0,0,0,0,0,0,0,0,0,0,0,0,0,17,1,1,0,0,0,0,0
1607,67819,7829,3752,4077,0500000US30013,30013,"Cascade County, Montana",Cascade County, Montana,1044,90,67,23,3823,634,295,339,47,18,18,0,3593,953,392,561,683,173,74,99,3143,1293,546,747,1174,411,215,196
1608,4375,312,123,189,0500000US30015,30015,"Chouteau County, Montana",Chouteau County, Montana,14,0,0,0,194,0,0,0,1,1,0,1,45,12,10,2,33,0,0,0,1038,490,252,238,10,0,0,0
1609,10268,1118,523,595,0500000US30017,30017,"Custer County, Montana",Custer County, Montana,80,0,0,0,386,66,31,35,16,0,0,0,398,24,0,24,58,0,0,0,68,32,0,32,79,10,0,10
1610,1544,112,69,43,0500000US30019,30019,"Daniels County, Montana",Daniels County, Montana,0,0,0,0,40,0,0,0,0,0,0,0,30,0,0,0,14,0,0,0,54,19,10,9,0,0,0,0
1611,7786,879,364,515,0500000US30021,30021,"Dawson County, Montana",Dawson County, Montana,37,0,0,0,204,65,51,14,0,0,0,0,232,21,9,12,24,0,0,0,77,0,0,0,41,0,0,0
1612,7740,1557,1031,526,0500000US30023,30023,"Deer Lodge County, Montana",Deer Lodge County, Montana,136,9,9,0,332,162,43,119,0,0,0,0,259,229,76,153,48,11,0,11,73,66,37,29,59,30,17,13
1613,2693,293,106,187,0500000US30025,30025,"Fallon County, Montana",Fallon County, Montana,0,0,0,0,39,0,0,0,0,0,0,0,38,0,0,0,30,0,0,0,91,68,32,36,3,0,0,0
1614,10223,1686,662,1024,0500000US30027,30027,"Fergus County, Montana",Fergus County, Montana,75,0,0,0,147,43,32,11,8,0,0,0,134,0,0,0,167,112,79,33,169,0,0,0,90,0,0,0
1615,93383,9069,4064,5005,0500000US30029,30029,"Flathead County, Montana",Flathead County, Montana,471,31,1,30,3175,537,199,338,13,0,0,0,2981,339,277,62,658,17,0,17,1526,392,87,305,499,73,26,47
1616,97827,10184,5090,5094,0500000US30031,30031,"Gallatin County, Montana",Gallatin County, Montana,441,120,35,85,3640,439,263,176,5,0,0,0,4203,698,311,387,1360,266,121,145,976,260,143,117,919,128,51,77
1617,1042,57,15,42,0500000US30033,30033,"Garfield County, Montana",Garfield County, Montana,6,0,0,0,0,0,0,0,0,0,0,0,3,0,0,0,0,0,0,0,0,0,0,0,0,0,0,0
1618,3990,906,409,497,0500000US30035,30035,"Glacier County, Montana",Glacier County, Montana,52,0,0,0,407,68,15,53,36,22,0,22,407,75,18,57,45,2,0,2,8646,2949,1351,1598,129,23,0,23
1619,687,119,57,62,0500000US30037,30037,"Golden Valley County, Montana",Golden Valley County, Montana,12,0,0,0,63,16,3,13,0,0,0,0,87,0,0,0,0,0,0,0,7,0,0,0,0,0,0,0
1620,3065,332,230,102,0500000US30039,30039,"Granite County, Montana",Granite County, Montana,7,0,0,0,91,12,0,12,0,0,0,0,76,2,2,0,11,4,4,0,32,0,0,0,0,0,0,0
1621,10988,1196,550,646,0500000US30041,30041,"Hill County, Montana",Hill County, Montana,51,17,0,17,681,95,85,10,0,0,0,0,608,140,42,98,87,40,0,40,3884,1326,652,674,175,0,0,0
1622,11042,726,347,379,0500000US30043,30043,"Jefferson County, Montana",Jefferson County, Montana,82,0,0,0,379,18,0,18,0,0,0,0,307,27,4,23,8,0,0,0,86,0,0,0,146,0,0,0
1623,1838,297,170,127,0500000US30045,30045,"Judith Basin County, Montana",Judith Basin County, Montana,0,0,0,0,66,0,0,0,0,0,0,0,64,24,24,0,0,0,0,0,46,37,34,3,0,0,0,0
1624,19594,2460,1175,1285,0500000US30047,30047,"Lake County, Montana",Lake County, Montana,99,32,32,0,2549,565,287,278,55,3,0,3,1305,299,123,176,154,0,0,0,6937,2298,1199,1099,142,39,7,32
1625,60910,5492,2816,2676,0500000US30049,30049,"Lewis and Clark County, Montana",Lewis and Clark County, Montana,216,95,46,49,2393,234,60,174,0,0,0,0,2298,480,216,264,427,2,2,0,853,98,56,42,627,87,28,59
1626,2394,515,187,328,0500000US30051,30051,"Liberty County, Montana",Liberty County, Montana,0,0,0,0,13,0,0,0,0,0,0,0,27,0,0,0,0,0,0,0,0,0,0,0,0,0,0,0
1627,18043,2923,1351,1572,0500000US30053,30053,"Lincoln County, Montana",Lincoln County, Montana,37,13,0,13,760,119,98,21,36,0,0,0,636,157,6,151,71,2,2,0,175,126,42,84,176,125,6,119
1628,1617,95,48,47,0500000US30055,30055,"McCone County, Montana",McCone County, Montana,0,0,0,0,10,0,0,0,0,0,0,0,65,0,0,0,46,0,0,0,51,0,0,0,0,0,0,0
1629,7826,537,287,250,0500000US30057,30057,"Madison County, Montana",Madison County, Montana,0,0,0,0,284,93,24,69,0,0,0,0,368,43,5,38,5,3,3,0,19,18,14,4,25,23,23,0
1630,1634,236,113,123,0500000US30059,30059,"Meagher County, Montana",Meagher County, Montana,0,0,0,0,58,0,0,0,0,0,0,0,92,0,0,0,8,0,0,0,12,0,0,0,61,0,0,0
1631,3897,752,343,409,0500000US30061,30061,"Mineral County, Montana",Mineral County, Montana,41,1,1,0,139,0,0,0,0,0,0,0,54,27,16,11,30,17,12,5,66,17,11,6,3,0,0,0
1632,102573,12968,6557,6411,0500000US30063,30063,"Missoula County, Montana",Missoula County, Montana,755,33,8,25,5124,1404,595,809,128,7,0,7,3929,448,236,212,2264,176,45,131,2171,443,173,270,664,117,114,3
1633,4261,480,185,295,0500000US30065,30065,"Musselshell County, Montana",Musselshell County, Montana,0,0,0,0,105,22,13,9,0,0,0,0,119,20,0,20,31,0,0,0,136,52,43,9,33,14,0,14
1634,15258,1771,784,987,0500000US30067,30067,"Park County, Montana",Park County, Montana,59,0,0,0,525,80,11,69,16,0,0,0,498,107,28,79,65,14,3,11,110,0,0,0,41,0,0,0
1635,439,55,26,29,0500000US30069,30069,"Petroleum County, Montana",Petroleum County, Montana,0,0,0,0,0,0,0,0,0,0,0,0,0,0,0,0,15,0,0,0,0,0,0,0,0,0,0,0
1636,3305,266,111,155,0500000US30071,30071,"Phillips County, Montana",Phillips County, Montana,0,0,0,0,354,46,2,44,0,0,0,0,120,12,0,12,26,0,0,0,258,79,54,25,15,0,0,0
1637,4714,680,282,398,0500000US30073,30073,"Pondera County, Montana",Pondera County, Montana,6,0,0,0,101,25,7,18,0,0,0,0,33,20,19,1,16,13,13,0,925,318,145,173,13,13,13,0
1638,1472,190,94,96,0500000US30075,30075,"Powder River County, Montana",Powder River County, Montana,0,0,0,0,41,33,1,32,0,0,0,0,70,33,1,32,0,0,0,0,53,0,0,0,0,0,0,0
1639,4897,679,479,200,0500000US30077,30077,"Powell County, Montana",Powell County, Montana,31,25,0,25,128,1,1,0,0,0,0,0,56,0,0,0,27,0,0,0,8,1,0,1,40,0,0,0
1640,1085,139,79,60,0500000US30079,30079,"Prairie County, Montana",Prairie County, Montana,0,0,0,0,0,0,0,0,0,0,0,0,18,0,0,0,22,22,22,0,16,0,0,0,2,0,0,0
1641,39445,4579,1907,2672,0500000US30081,30081,"Ravalli County, Montana",Ravalli County, Montana,106,6,5,1,1942,238,61,177,0,0,0,0,1526,406,95,311,256,22,4,18,295,62,56,6,38,5,0,5
1642,9740,644,261,383,0500000US30083,30083,"Richland County, Montana",Richland County, Montana,0,0,0,0,540,4,2,2,44,0,0,0,610,112,22,90,2,0,0,0,216,0,0,0,316,0,0,0
1643,3581,406,191,215,0500000US30085,30085,"Roosevelt County, Montana",Roosevelt County, Montana,22,14,14,0,508,54,22,32,0,0,0,0,364,50,36,14,81,0,0,0,6295,2717,1401,1316,16,4,3,1
1644,4698,387,198,189,0500000US30087,30087,"Rosebud County, Montana",Rosebud County, Montana,22,0,0,0,406,0,0,0,0,0,0,0,433,48,23,25,64,3,3,0,3447,1069,520,549,282,0,0,0
1645,10442,1625,700,925,0500000US30089,30089,"Sanders County, Montana",Sanders County, Montana,31,17,17,0,381,81,58,23,2,0,0,0,360,94,57,37,47,7,0,7,430,115,78,37,25,19,13,6
1646,3011,251,115,136,0500000US30091,30091,"Sheridan County, Montana",Sheridan County, Montana,0,0,0,0,150,80,33,47,0,0,0,0,144,12,7,5,16,0,0,0,13,0,0,0,7,2,2,0
1647,30634,4483,2312,2171,0500000US30093,30093,"Silver Bow County, Montana",Silver Bow County, Montana,94,29,0,29,958,314,165,149,8,0,0,0,1594,257,66,191,255,92,77,15,747,471,307,164,82,8,0,8
1648,8820,460,193,267,0500000US30095,30095,"Stillwater County, Montana",Stillwater County, Montana,7,6,0,6,242,22,19,3,0,0,0,0,382,46,18,28,18,0,0,0,101,0,0,0,24,16,6,10
1649,3371,149,102,47,0500000US30097,30097,"Sweet Grass County, Montana",Sweet Grass County, Montana,0,0,0,0,94,16,0,16,0,0,0,0,122,4,0,4,9,0,0,0,47,0,0,0,0,0,0,0
1650,5632,770,311,459,0500000US30099,30099,"Teton County, Montana",Teton County, Montana,37,23,0,23,265,3,0,3,0,0,0,0,30,5,0,5,7,0,0,0,60,0,0,0,2,0,0,0
1651,3787,403,204,199,0500000US30101,30101,"Toole County, Montana",Toole County, Montana,0,0,0,0,106,32,18,14,0,0,0,0,117,0,0,0,22,0,0,0,247,0,0,0,13,0,0,0
1652,606,68,36,32,0500000US30103,30103,"Treasure County, Montana",Treasure County, Montana,0,0,0,0,0,0,0,0,0,0,0,0,2,0,0,0,5,0,0,0,1,0,0,0,0,0,0,0
1653,6191,617,240,377,0500000US30105,30105,"Valley County, Montana",Valley County, Montana,26,0,0,0,342,141,46,95,10,0,0,0,69,8,3,5,15,0,0,0,672,239,113,126,9,0,0,0
1654,1997,417,210,207,0500000US30107,30107,"Wheatland County, Montana",Wheatland County, Montana,0,0,0,0,46,0,0,0,0,0,0,0,35,0,0,0,17,0,0,0,14,0,0,0,0,0,0,0
1655,930,87,23,64,0500000US30109,30109,"Wibaux County, Montana",Wibaux County, Montana,0,0,0,0,0,0,0,0,0,0,0,0,76,21,11,10,5,0,0,0,6,0,0,0,0,0,0,0
1656,134703,11953,5275,6678,0500000US30111,30111,"Yellowstone County, Montana",Yellowstone County, Montana,1343,59,59,0,6438,741,366,375,86,2,2,0,9179,1281,707,574,1137,196,82,114,5755,988,522,466,1594,277,212,65
1657,25577,2690,1057,1633,0500000US31001,31001,"Adams County, Nebraska",Adams County, Nebraska,123,22,18,4,814,209,48,161,0,0,0,0,3202,775,344,431,412,54,45,9,81,30,2,28,932,184,91,93
1658,5898,612,296,316,0500000US31003,31003,"Antelope County, Nebraska",Antelope County, Nebraska,71,20,10,10,73,18,6,12,1,0,0,0,215,38,12,26,17,0,0,0,0,0,0,0,55,9,4,5
1659,418,53,16,37,0500000US31005,31005,"Arthur County, Nebraska",Arthur County, Nebraska,0,0,0,0,15,0,0,0,0,0,0,0,7,2,0,2,0,0,0,0,1,0,0,0,1,0,0,0
1660,584,10,2,8,0500000US31007,31007,"Banner County, Nebraska",Banner County, Nebraska,0,0,0,0,9,0,0,0,0,0,0,0,43,12,4,8,6,0,0,0,0,0,0,0,9,0,0,0
1661,467,19,10,9,0500000US31009,31009,"Blaine County, Nebraska",Blaine County, Nebraska,0,0,0,0,0,0,0,0,0,0,0,0,0,0,0,0,0,0,0,0,0,0,0,0,0,0,0,0
1662,4935,286,147,139,0500000US31011,31011,"Boone County, Nebraska",Boone County, Nebraska,7,0,0,0,63,21,9,12,0,0,0,0,117,22,22,0,20,0,0,0,3,0,0,0,0,0,0,0
1663,8629,1002,367,635,0500000US31013,31013,"Box Butte County, Nebraska",Box Butte County, Nebraska,377,0,0,0,111,43,0,43,0,0,0,0,1375,221,20,201,88,0,0,0,158,95,24,71,159,20,20,0
1664,1745,182,50,132,0500000US31015,31015,"Boyd County, Nebraska",Boyd County, Nebraska,4,2,2,0,44,1,0,1,0,0,0,0,57,0,0,0,4,0,0,0,13,0,0,0,20,0,0,0
1665,2680,255,112,143,0500000US31017,31017,"Brown County, Nebraska",Brown County, Nebraska,0,0,0,0,72,16,12,4,0,0,0,0,72,0,0,0,11,0,0,0,5,4,4,0,0,0,0,0
1666,41094,4540,2174,2366,0500000US31019,31019,"Buffalo County, Nebraska",Buffalo County, Nebraska,352,69,21,48,1199,131,111,20,3,0,0,0,4336,810,314,496,627,100,17,83,66,21,12,9,1906,204,65,139
1667,5944,671,372,299,0500000US31021,31021,"Burt County, Nebraska",Burt County, Nebraska,14,0,0,0,145,31,15,16,13,0,0,0,204,64,18,46,21,8,0,8,166,39,14,25,57,46,13,33
1668,7344,536,216,320,0500000US31023,31023,"Butler County, Nebraska",Butler County, Nebraska,0,0,0,0,160,17,8,9,0,0,0,0,283,70,44,26,15,0,0,0,53,0,0,0,58,0,0,0
1669,23649,1377,628,749,0500000US31025,31025,"Cass County, Nebraska",Cass County, Nebraska,53,2,2,0,672,83,47,36,63,0,0,0,860,220,126,94,97,35,5,30,99,9,0,9,281,18,7,11
1670,8027,479,187,292,0500000US31027,31027,"Cedar County, Nebraska",Cedar County, Nebraska,4,0,0,0,78,19,3,16,0,0,0,0,166,25,2,23,4,0,0,0,64,46,32,14,81,18,0,18
1671,3029,233,95,138,0500000US31029,31029,"Chase County, Nebraska",Chase County, Nebraska,3,2,2,0,213,1,1,0,0,0,0,0,522,89,37,52,27,0,0,0,0,0,0,0,1,0,0,0
1672,4999,486,200,286,0500000US31031,31031,"Cherry County, Nebraska",Cherry County, Nebraska,8,8,8,0,337,22,22,0,31,0,0,0,111,0,0,0,78,0,0,0,221,46,5,41,15,0,0,0
1673,8241,875,362,513,0500000US31033,31033,"Cheyenne County, Nebraska",Cheyenne County, Nebraska,60,1,0,1,363,67,6,61,2,0,0,0,689,67,11,56,74,0,0,0,55,36,29,7,48,11,11,0
1674,5376,395,181,214,0500000US31035,31035,"Clay County, Nebraska",Clay County, Nebraska,19,0,0,0,165,43,24,19,0,0,0,0,554,156,82,74,1,0,0,0,33,0,0,0,89,6,0,6
1675,5093,507,266,241,0500000US31037,31037,"Colfax County, Nebraska",Colfax County, Nebraska,402,0,0,0,918,205,3,202,3,0,0,0,4669,678,382,296,78,24,24,0,209,16,10,6,574,40,0,40
1676,7689,396,140,256,0500000US31039,31039,"Cuming County, Nebraska",Cuming County, Nebraska,21,0,0,0,334,0,0,0,13,0,0,0,872,34,21,13,15,0,0,0,35,0,0,0,252,14,4,10
1677,10005,1163,531,632,0500000US31041,31041,"Custer County, Nebraska",Custer County, Nebraska,8,0,0,0,207,37,28,9,0,0,0,0,352,110,28,82,78,0,0,0,31,0,0,0,104,14,8,6
1678,9217,1158,445,713,0500000US31043,31043,"Dakota County, Nebraska",Dakota County, Nebraska,1206,204,8,196,1758,76,0,76,0,0,0,0,7835,1138,629,509,666,63,40,23,354,182,110,72,3468,639,408,231
1679,6555,615,261,354,0500000US31045,31045,"Dawes County, Nebraska",Dawes County, Nebraska,182,60,0,60,365,174,68,106,0,0,0,0,473,265,136,129,44,0,0,0,246,65,17,48,0,0,0,0
1680,13506,893,345,548,0500000US31047,31047,"Dawson County, Nebraska",Dawson County, Nebraska,1461,169,96,73,1024,373,265,108,2,0,0,0,7877,1579,703,876,187,48,14,34,74,41,20,21,1180,500,220,280
1681,1523,130,56,74,0500000US31049,31049,"Deuel County, Nebraska",Deuel County, Nebraska,4,0,0,0,38,2,0,2,0,0,0,0,166,12,0,12,11,0,0,0,25,0,0,0,3,0,0,0
1682,4685,492,235,257,0500000US31051,31051,"Dixon County, Nebraska",Dixon County, Nebraska,3,3,0,3,212,54,32,22,0,0,0,0,802,49,16,33,21,3,2,1,22,0,0,0,206,0,0,0
1683,29444,2905,1194,1711,0500000US31053,31053,"Dodge County, Nebraska",Dodge County, Nebraska,360,162,7,155,1012,86,23,63,36,0,0,0,4857,730,373,357,234,110,58,52,285,77,67,10,472,13,13,0
1684,381391,26762,12086,14676,0500000US31055,31055,"Douglas County, Nebraska",Douglas County, Nebraska,59753,14782,6195,8587,25604,3447,1533,1914,225,61,43,18,70740,11974,5706,6268,22302,3076,1507,1569,2653,425,177,248,14547,1805,937,868
1685,1719,197,77,120,0500000US31057,31057,"Dundy County, Nebraska",Dundy County, Nebraska,0,0,0,0,4,4,4,0,0,0,0,0,170,10,10,0,0,0,0,0,1,0,0,0,9,2,2,0
1686,5029,324,139,185,0500000US31059,31059,"Fillmore County, Nebraska",Fillmore County, Nebraska,3,1,0,1,69,3,1,2,0,0,0,0,184,41,12,29,50,0,0,0,8,1,1,0,21,0,0,0
1687,2755,447,193,254,0500000US31061,31061,"Franklin County, Nebraska",Franklin County, Nebraska,7,1,1,0,51,11,6,5,9,0,0,0,70,7,7,0,10,0,0,0,1,0,0,0,29,1,1,0
1688,2404,206,73,133,0500000US31063,31063,"Frontier County, Nebraska",Frontier County, Nebraska,26,7,4,3,50,21,21,0,0,0,0,0,46,13,12,1,2,0,0,0,5,0,0,0,9,0,0,0
1689,4306,329,137,192,0500000US31065,31065,"Furnas County, Nebraska",Furnas County, Nebraska,7,4,4,0,82,19,12,7,1,0,0,0,212,51,38,13,16,3,0,3,6,1,0,1,36,23,16,7
1690,19814,2448,723,1725,0500000US31067,31067,"Gage County, Nebraska",Gage County, Nebraska,115,60,33,27,297,98,77,21,0,0,0,0,585,129,75,54,123,2,0,2,144,38,38,0,116,17,17,0
1691,1764,156,64,92,0500000US31069,31069,"Garden County, Nebraska",Garden County, Nebraska,0,0,0,0,14,5,2,3,0,0,0,0,92,0,0,0,4,0,0,0,8,0,0,0,15,0,0,0
1692,1957,172,113,59,0500000US31071,31071,"Garfield County, Nebraska",Garfield County, Nebraska,2,0,0,0,12,1,1,0,0,0,0,0,30,0,0,0,3,0,0,0,0,0,0,0,24,0,0,0
1693,1855,91,31,60,0500000US31073,31073,"Gosper County, Nebraska",Gosper County, Nebraska,4,4,0,4,13,0,0,0,4,0,0,0,80,6,0,6,8,0,0,0,0,0,0,0,1,0,0,0
1694,643,109,59,50,0500000US31075,31075,"Grant County, Nebraska",Grant County, Nebraska,5,2,0,2,7,4,0,4,0,0,0,0,0,0,0,0,0,0,0,0,1,0,0,0,6,0,0,0
1695,2236,304,109,195,0500000US31077,31077,"Greeley County, Nebraska",Greeley County, Nebraska,5,0,0,0,23,0,0,0,0,0,0,0,53,11,0,11,3,0,0,0,6,5,0,5,27,6,0,6
1696,39480,2923,1120,1803,0500000US31079,31079,"Hall County, Nebraska",Hall County, Nebraska,1751,560,363,197,2303,273,172,101,247,16,0,16,17369,3030,1412,1618,675,47,25,22,424,111,35,76,7243,1153,649,504
1697,8571,249,87,162,0500000US31081,31081,"Hamilton County, Nebraska",Hamilton County, Nebraska,0,0,0,0,245,0,0,0,9,9,0,9,332,63,38,25,48,0,0,0,0,0,0,0,102,63,38,25
1698,3141,330,102,228,0500000US31083,31083,"Harlan County, Nebraska",Harlan County, Nebraska,24,1,1,0,34,2,2,0,1,1,1,0,108,7,2,5,47,0,0,0,11,0,0,0,49,0,0,0
1699,824,115,68,47,0500000US31085,31085,"Hayes County, Nebraska",Hayes County, Nebraska,0,0,0,0,7,7,1,6,0,0,0,0,63,9,2,7,0,0,0,0,2,0,0,0,13,1,1,0
1700,2579,235,90,145,0500000US31087,31087,"Hitchcock County, Nebraska",Hitchcock County, Nebraska,0,0,0,0,118,97,78,19,0,0,0,0,41,0,0,0,0,0,0,0,4,4,0,4,0,0,0,0
1701,9262,620,326,294,0500000US31089,31089,"Holt County, Nebraska",Holt County, Nebraska,21,18,18,0,134,4,0,4,2,0,0,0,513,2,0,2,41,0,0,0,64,8,0,8,28,0,0,0
1702,593,76,30,46,0500000US31091,31091,"Hooker County, Nebraska",Hooker County, Nebraska,4,0,0,0,41,0,0,0,0,0,0,0,53,0,0,0,0,0,0,0,4,4,4,0,25,0,0,0
1703,5902,322,147,175,0500000US31093,31093,"Howard County, Nebraska",Howard County, Nebraska,10,5,0,5,294,38,3,35,2,0,0,0,168,22,22,0,18,0,0,0,3,3,3,0,100,3,3,0
1704,6484,594,245,349,0500000US31095,31095,"Jefferson County, Nebraska",Jefferson County, Nebraska,49,0,0,0,92,35,11,24,0,0,0,0,312,95,0,95,22,22,0,22,30,30,0,30,46,0,0,0
1705,3539,225,70,155,0500000US31097,31097,"Johnson County, Nebraska",Johnson County, Nebraska,19,11,11,0,191,0,0,0,0,0,0,0,384,53,18,35,55,6,6,0,0,0,0,0,130,0,0,0
1706,5913,513,171,342,0500000US31099,31099,"Kearney County, Nebraska",Kearney County, Nebraska,4,0,0,0,132,0,0,0,0,0,0,0,449,131,90,41,30,0,0,0,53,0,0,0,21,0,0,0
1707,7127,943,395,548,0500000US31101,31101,"Keith County, Nebraska",Keith County, Nebraska,129,70,70,0,139,110,27,83,6,6,4,2,592,144,30,114,36,8,5,3,58,53,41,12,31,0,0,0
1708,863,61,20,41,0500000US31103,31103,"Keya Paha County, Nebraska",Keya Paha County, Nebraska,0,0,0,0,11,0,0,0,0,0,0,0,11,0,0,0,0,0,0,0,0,0,0,0,1,0,0,0
1709,3032,279,151,128,0500000US31105,31105,"Kimball County, Nebraska",Kimball County, Nebraska,4,0,0,0,127,2,0,2,0,0,0,0,332,87,45,42,12,0,0,0,73,53,5,48,7,0,0,0
1710,7012,477,175,302,0500000US31107,31107,"Knox County, Nebraska",Knox County, Nebraska,16,1,1,0,193,10,6,4,2,0,0,0,251,40,23,17,30,5,3,2,796,275,139,136,52,11,10,1
1711,244467,23395,10758,12637,0500000US31109,31109,"Lancaster County, Nebraska",Lancaster County, Nebraska,11010,2790,1504,1286,13755,3155,1425,1730,193,124,53,71,21932,5600,2633,2967,12946,1711,858,853,1769,317,191,126,4051,1515,719,796
1712,29834,2544,828,1716,0500000US31111,31111,"Lincoln County, Nebraska",Lincoln County, Nebraska,527,73,52,21,927,43,32,11,18,3,3,0,3064,595,306,289,248,13,2,11,201,17,16,1,254,36,36,0
1713,852,98,43,55,0500000US31113,31113,"Logan County, Nebraska",Logan County, Nebraska,0,0,0,0,7,0,0,0,0,0,0,0,26,0,0,0,0,0,0,0,4,0,0,0,0,0,0,0
1714,620,61,29,32,0500000US31115,31115,"Loup County, Nebraska",Loup County, Nebraska,0,0,0,0,58,0,0,0,0,0,0,0,58,0,0,0,0,0,0,0,3,0,0,0,0,0,0,0
1715,415,57,29,28,0500000US31117,31117,"McPherson County, Nebraska",McPherson County, Nebraska,0,0,0,0,0,0,0,0,0,0,0,0,5,0,0,0,0,0,0,0,0,0,0,0,5,0,0,0
1716,26895,3181,1251,1930,0500000US31119,31119,"Madison County, Nebraska",Madison County, Nebraska,405,105,62,43,1012,430,247,183,0,0,0,0,5332,1397,755,642,621,7,0,7,523,36,30,6,1055,266,206,60
1717,7060,802,392,410,0500000US31121,31121,"Merrick County, Nebraska",Merrick County, Nebraska,47,43,0,43,144,32,21,11,0,0,0,0,369,56,32,24,96,0,0,0,24,0,0,0,101,8,5,3
1718,3731,250,73,177,0500000US31123,31123,"Morrill County, Nebraska",Morrill County, Nebraska,0,0,0,0,282,10,10,0,0,0,0,0,719,182,65,117,37,0,0,0,15,0,0,0,16,8,3,5
1719,3290,402,139,263,0500000US31125,31125,"Nance County, Nebraska",Nance County, Nebraska,3,0,0,0,58,0,0,0,0,0,0,0,100,7,0,7,0,0,0,0,19,7,0,7,8,0,0,0
1720,5946,857,403,454,0500000US31127,31127,"Nemaha County, Nebraska",Nemaha County, Nebraska,64,38,24,14,251,19,1,18,2,0,0,0,130,39,26,13,50,1,0,1,18,1,0,1,8,1,0,1
1721,3898,372,159,213,0500000US31129,31129,"Nuckolls County, Nebraska",Nuckolls County, Nebraska,6,0,0,0,29,0,0,0,7,0,0,0,123,0,0,0,47,0,0,0,31,0,0,0,3,0,0,0
1722,13807,1373,600,773,0500000US31131,31131,"Otoe County, Nebraska",Otoe County, Nebraska,96,44,29,15,534,176,53,123,0,0,0,0,1282,364,192,172,35,0,0,0,12,10,1,9,394,90,90,0
1723,2466,462,203,259,0500000US31133,31133,"Pawnee County, Nebraska",Pawnee County, Nebraska,5,0,0,0,87,36,3,33,0,0,0,0,51,43,21,22,0,0,0,0,0,0,0,0,0,0,0,0
1724,2690,186,73,113,0500000US31135,31135,"Perkins County, Nebraska",Perkins County, Nebraska,5,0,0,0,31,4,0,4,0,0,0,0,127,2,0,2,0,0,0,0,4,1,0,1,19,0,0,0
1725,8071,698,310,388,0500000US31137,31137,"Phelps County, Nebraska",Phelps County, Nebraska,9,0,0,0,276,203,132,71,13,0,0,0,503,302,181,121,19,3,0,3,79,3,0,3,46,26,26,0
1726,6677,548,240,308,0500000US31139,31139,"Pierce County, Nebraska",Pierce County, Nebraska,8,0,0,0,189,33,0,33,0,0,0,0,146,20,0,20,18,0,0,0,13,0,0,0,13,13,0,13
1727,25417,1261,645,616,0500000US31141,31141,"Platte County, Nebraska",Platte County, Nebraska,160,6,6,0,1267,31,28,3,5,0,0,0,6569,1196,520,676,255,25,25,0,67,26,26,0,1257,204,83,121
1728,4688,428,183,245,0500000US31143,31143,"Polk County, Nebraska",Polk County, Nebraska,10,3,3,0,119,5,3,2,0,0,0,0,300,36,0,36,0,0,0,0,9,0,0,0,103,28,0,28
1729,9500,957,492,465,0500000US31145,31145,"Red Willow County, Nebraska",Red Willow County, Nebraska,21,0,0,0,355,45,1,44,0,0,0,0,545,68,0,68,19,0,0,0,36,25,0,25,130,0,0,0
1730,7123,901,338,563,0500000US31147,31147,"Richardson County, Nebraska",Richardson County, Nebraska,78,0,0,0,280,0,0,0,0,0,0,0,157,3,3,0,11,0,0,0,178,42,7,35,2,0,0,0
1731,1317,86,24,62,0500000US31149,31149,"Rock County, Nebraska",Rock County, Nebraska,17,0,0,0,9,0,0,0,0,0,0,0,9,0,0,0,0,0,0,0,13,0,0,0,2,0,0,0
1732,8975,710,334,376,0500000US31151,31151,"Saline County, Nebraska",Saline County, Nebraska,174,40,30,10,508,15,8,7,0,0,0,0,3534,800,353,447,452,75,0,75,33,0,0,0,615,124,26,98
1733,145857,6265,2571,3694,0500000US31153,31153,"Sarpy County, Nebraska",Sarpy County, Nebraska,7087,1062,576,486,8306,654,309,345,144,22,22,0,17359,2196,914,1282,4738,214,122,92,841,86,18,68,4360,1170,520,650
1734,20041,1178,497,681,0500000US31155,31155,"Saunders County, Nebraska",Saunders County, Nebraska,128,22,0,22,371,40,39,1,0,0,0,0,461,77,55,22,74,0,0,0,32,6,2,4,46,0,0,0
1735,24870,2661,1172,1489,0500000US31157,31157,"Scotts Bluff County, Nebraska",Scotts Bluff County, Nebraska,208,52,41,11,1929,116,84,32,40,0,0,0,8539,1602,688,914,223,30,12,18,672,149,54,95,1031,125,19,106
1736,15009,1007,524,483,0500000US31159,31159,"Seward County, Nebraska",Seward County, Nebraska,56,4,4,0,353,68,41,27,0,0,0,0,366,75,63,12,35,0,0,0,14,1,0,1,77,3,0,3
1737,4162,551,230,321,0500000US31161,31161,"Sheridan County, Nebraska",Sheridan County, Nebraska,120,85,50,35,219,63,17,46,1,0,0,0,298,175,94,81,62,0,0,0,488,227,89,138,16,8,8,0
1738,2827,284,128,156,0500000US31163,31163,"Sherman County, Nebraska",Sherman County, Nebraska,5,0,0,0,31,2,0,2,0,0,0,0,65,13,10,3,21,0,0,0,0,0,0,0,32,10,10,0
1739,1191,92,55,37,0500000US31165,31165,"Sioux County, Nebraska",Sioux County, Nebraska,37,0,0,0,9,0,0,0,0,0,0,0,54,13,0,13,0,0,0,0,7,0,0,0,53,13,0,13
1740,5338,271,71,200,0500000US31167,31167,"Stanton County, Nebraska",Stanton County, Nebraska,116,0,0,0,61,0,0,0,0,0,0,0,355,93,38,55,11,0,0,0,0,0,0,0,50,0,0,0
1741,4537,461,180,281,0500000US31169,31169,"Thayer County, Nebraska",Thayer County, Nebraska,15,1,1,0,150,12,1,11,0,0,0,0,139,27,14,13,0,0,0,0,10,10,10,0,31,0,0,0
1742,579,63,27,36,0500000US31171,31171,"Thomas County, Nebraska",Thomas County, Nebraska,0,0,0,0,5,0,0,0,0,0,0,0,0,0,0,0,0,0,0,0,2,2,0,2,0,0,0,0
1743,2504,137,49,88,0500000US31173,31173,"Thurston County, Nebraska",Thurston County, Nebraska,12,2,2,0,215,23,11,12,0,0,0,0,499,101,46,55,53,7,3,4,4148,1288,601,687,66,0,0,0
1744,3876,338,162,176,0500000US31175,31175,"Valley County, Nebraska",Valley County, Nebraska,17,0,0,0,35,1,1,0,0,0,0,0,89,30,15,15,0,0,0,0,15,0,0,0,6,0,0,0
1745,19104,1294,583,711,0500000US31177,31177,"Washington County, Nebraska",Washington County, Nebraska,124,48,26,22,403,132,92,40,34,34,0,34,583,1,1,0,62,0,0,0,0,0,0,0,131,0,0,0
1746,7267,863,376,487,0500000US31179,31179,"Wayne County, Nebraska",Wayne County, Nebraska,59,38,0,38,178,16,4,12,0,0,0,0,525,29,18,11,12,8,3,5,6,0,0,0,10,1,1,0
1747,3116,233,97,136,0500000US31181,31181,"Webster County, Nebraska",Webster County, Nebraska,3,3,3,0,73,0,0,0,30,10,2,8,181,28,13,15,0,0,0,0,29,0,0,0,7,7,3,4
1748,672,77,39,38,0500000US31183,31183,"Wheeler County, Nebraska",Wheeler County, Nebraska,0,0,0,0,2,0,0,0,0,0,0,0,14,10,2,8,1,0,0,0,0,0,0,0,4,0,0,0
1749,11805,819,280,539,0500000US31185,31185,"York County, Nebraska",York County, Nebraska,99,23,8,15,320,115,31,84,0,0,0,0,475,101,53,48,27,0,0,0,4,4,4,0,122,39,18,21
1750,17432,1445,529,916,0500000US32001,32001,"Churchill County, Nevada",Churchill County, Nevada,571,297,173,124,1461,77,27,50,21,10,4,6,3447,992,596,396,654,32,21,11,1198,228,116,112,1153,598,395,203
1751,920110,84155,39888,44267,0500000US32003,32003,"Clark County, Nevada",Clark County, Nevada,259309,57414,26524,30890,177753,23251,10359,12892,17406,2937,1122,1815,690199,116881,51534,65347,219784,19854,8567,11287,18656,4447,1904,2543,261518,48683,20574,28109
1752,38450,2529,1182,1347,0500000US32005,32005,"Douglas County, Nevada",Douglas County, Nevada,333,25,7,18,2153,185,83,102,112,10,7,3,6111,627,368,259,928,40,6,34,813,193,94,99,1990,500,316,184
1753,33704,3345,1525,1820,0500000US32007,32007,"Elko County, Nevada",Elko County, Nevada,575,258,212,46,2929,231,92,139,70,2,0,2,12618,1541,718,823,635,11,4,7,2895,801,262,539,3113,277,106,171
1754,734,57,16,41,0500000US32009,32009,"Esmeralda County, Nevada",Esmeralda County, Nevada,15,0,0,0,0,0,0,0,0,0,0,0,261,78,78,0,0,0,0,0,14,0,0,0,0,0,0,0
1755,1668,328,171,157,0500000US32011,32011,"Eureka County, Nevada",Eureka County, Nevada,0,0,0,0,0,0,0,0,0,0,0,0,88,8,0,8,11,0,0,0,67,0,0,0,17,8,0,8
1756,10799,1228,422,806,0500000US32013,32013,"Humboldt County, Nevada",Humboldt County, Nevada,120,1,0,1,559,272,107,165,9,2,0,2,4570,712,202,510,151,0,0,0,803,457,205,252,1171,83,29,54
1757,3833,434,159,275,0500000US32015,32015,"Lander County, Nevada",Lander County, Nevada,87,87,54,33,68,13,5,8,0,0,0,0,1365,142,83,59,4,0,0,0,273,58,36,22,31,3,0,3
1758,4087,198,49,149,0500000US32017,32017,"Lincoln County, Nevada",Lincoln County, Nevada,15,15,0,15,221,1,0,1,0,0,0,0,361,33,0,33,31,0,0,0,50,15,0,15,95,1,0,1
1759,41120,3634,1744,1890,0500000US32019,32019,"Lyon County, Nevada",Lyon County, Nevada,464,10,6,4,3471,267,169,98,101,3,3,0,9762,1157,552,605,698,67,56,11,1508,556,181,375,3189,365,108,257
1760,2715,334,211,123,0500000US32021,32021,"Mineral County, Nevada",Mineral County, Nevada,122,66,27,39,108,49,49,0,0,0,0,0,621,172,55,117,65,14,0,14,915,320,165,155,101,0,0,0
1761,33568,5653,2563,3090,0500000US32023,32023,"Nye County, Nevada",Nye County, Nevada,911,30,30,0,2620,263,128,135,180,0,0,0,6667,1211,655,556,793,46,7,39,705,171,76,95,3249,719,357,362
1762,3387,325,159,166,0500000US32027,32027,"Pershing County, Nevada",Pershing County, Nevada,10,6,4,2,228,13,0,13,0,0,0,0,948,89,45,44,97,3,3,0,202,31,15,16,339,52,38,14
1763,3319,317,184,133,0500000US32029,32029,"Storey County, Nevada",Storey County, Nevada,110,4,4,0,487,44,32,12,0,0,0,0,105,12,1,11,34,0,0,0,16,0,0,0,11,11,0,11
1764,285168,26936,12610,14326,0500000US32031,32031,"Washoe County, Nevada",Washoe County, Nevada,10849,1935,986,949,30177,3837,1851,1986,3111,314,192,122,113182,16229,7684,8545,25721,2112,992,1120,7076,1086,503,583,41322,6511,3041,3470
1765,6199,595,280,315,0500000US32033,32033,"White Pine County, Nevada",White Pine County, Nevada,25,13,12,1,216,13,6,7,0,0,0,0,1259,258,163,95,67,0,0,0,377,127,56,71,148,41,31,10
1766,35272,2587,1242,1345,0500000US32510,32510,"Carson City, Nevada",Carson City, Nevada,683,78,52,26,2641,663,294,369,22,0,0,0,12927,1806,766,1040,1542,95,31,64,1231,191,79,112,4516,557,186,371
1767,57143,4846,2210,2636,0500000US33001,33001,"Belknap County, New Hampshire",Belknap County, New Hampshire,358,124,104,20,1117,102,33,69,7,0,0,0,1067,140,21,119,622,35,11,24,205,0,0,0,169,4,3,1
1768,45712,3778,1630,2148,0500000US33003,33003,"Carroll County, New Hampshire",Carroll County, New Hampshire,226,99,99,0,776,173,106,67,0,0,0,0,739,98,28,70,359,27,13,14,127,0,0,0,75,11,11,0
1769,67393,6225,2884,3341,0500000US33005,33005,"Cheshire County, New Hampshire",Cheshire County, New Hampshire,527,59,12,47,1734,89,44,45,31,0,0,0,1247,86,23,63,680,23,0,23,161,63,45,18,375,2,0,2
1770,28632,3334,1564,1770,0500000US33007,33007,"Coos County, New Hampshire",Coos County, New Hampshire,56,12,10,2,330,47,19,28,1,0,0,0,205,20,15,5,170,15,15,0,44,0,0,0,9,2,1,1
1771,76451,7031,3229,3802,0500000US33009,33009,"Grafton County, New Hampshire",Grafton County, New Hampshire,736,319,82,237,2458,618,238,380,43,12,12,0,1859,454,221,233,2506,294,43,251,235,18,3,15,223,78,53,25
1772,340651,21127,8767,12360,0500000US33011,33011,"Hillsborough County, New Hampshire",Hillsborough County, New Hampshire,11178,2431,1126,1305,16250,2007,663,1344,142,5,0,5,28887,5049,2149,2900,17175,1224,787,437,488,38,21,17,4367,453,258,195
1773,133315,8257,3770,4487,0500000US33013,33013,"Merrimack County, New Hampshire",Merrimack County, New Hampshire,1812,213,122,91,3278,382,157,225,9,0,0,0,2842,321,88,233,3001,394,62,332,479,77,19,58,457,0,0,0
1774,281017,12420,4835,7585,0500000US33015,33015,"Rockingham County, New Hampshire",Rockingham County, New Hampshire,2618,79,44,35,7189,360,233,127,54,16,0,16,9487,865,441,424,6210,279,85,194,143,0,0,0,1917,244,88,156
1775,108825,9310,3984,5326,0500000US33017,33017,"Strafford County, New Hampshire",Strafford County, New Hampshire,1166,141,108,33,3766,236,102,134,109,0,0,0,3006,379,208,171,4107,678,307,371,85,58,22,36,443,9,2,7
1776,40142,4420,2148,2272,0500000US33019,33019,"Sullivan County, New Hampshire",Sullivan County, New Hampshire,203,24,23,1,827,307,130,177,0,0,0,0,700,17,0,17,333,0,0,0,108,0,0,0,152,17,0,17
1777,144640,10169,4309,5860,0500000US34001,34001,"Atlantic County, New Jersey",Atlantic County, New Jersey,36305,8550,3660,4890,15319,2375,776,1599,122,44,15,29,49750,11895,4761,7134,20646,3200,1751,1449,1302,639,333,306,21705,6493,2412,4081
1778,510811,23378,9600,13778,0500000US34003,34003,"Bergen County, New Jersey",Bergen County, New Jersey,52874,5017,2340,2677,47753,3340,1131,2209,314,0,0,0,187485,20995,8432,12563,153127,8422,3722,4700,1872,244,92,152,29301,4468,1858,2610
1779,292607,13409,5678,7731,0500000US34005,34005,"Burlington County, New Jersey",Burlington County, New Jersey,70262,6146,2513,3633,20682,2439,1070,1369,301,84,52,32,35136,4112,1817,2295,22835,821,367,454,617,32,0,32,9364,1400,623,777
1780,280077,18078,7527,10551,0500000US34007,34007,"Camden County, New Jersey",Camden County, New Jersey,95684,16533,6422,10111,23030,4275,2024,2251,193,18,0,18,86599,22983,9775,13208,29324,3961,1756,2205,889,234,135,99,38801,12795,5778,7017
1781,77451,6042,2719,3323,0500000US34009,34009,"Cape May County, New Jersey",Cape May County, New Jersey,3528,627,287,340,2782,433,259,174,16,0,0,0,7191,1913,802,1111,545,66,29,37,34,6,6,0,1761,675,349,326
1782,64447,5367,2208,3159,0500000US34011,34011,"Cumberland County, New Jersey",Cumberland County, New Jersey,24700,6788,2881,3907,9262,877,548,329,9,0,0,0,44549,9829,4166,5663,1940,98,30,68,1297,155,77,78,9239,2778,1086,1692
1783,233542,14002,6156,7846,0500000US34013,34013,"Essex County, New Jersey",Essex County, New Jersey,304768,62686,25937,36749,41955,7110,3202,3908,318,78,53,25,182633,38307,16539,21768,42453,2558,1046,1512,2028,449,285,164,67008,14894,6330,8564
1784,224602,12242,5479,6763,0500000US34015,34015,"Gloucester County, New Jersey",Gloucester County, New Jersey,29717,3834,1863,1971,9610,1502,811,691,22,0,0,0,18452,2818,1243,1575,8810,415,243,172,321,0,0,0,5854,1134,343,791
1785,189167,18350,8611,9739,0500000US34017,34017,"Hudson County, New Jersey",Hudson County, New Jersey,79097,15208,6316,8892,52589,7047,3372,3675,372,45,45,0,283005,50356,21603,28753,105277,9813,4899,4914,3274,500,292,208,89101,16096,7243,8853
1786,104735,3490,1653,1837,0500000US34019,34019,"Hunterdon County, New Jersey",Hunterdon County, New Jersey,1528,213,49,164,3386,72,17,55,43,4,0,4,7891,697,274,423,5232,298,108,190,117,12,0,12,1051,172,89,83
1787,171393,10203,4261,5942,0500000US34021,34021,"Mercer County, New Jersey",Mercer County, New Jersey,71752,14186,6065,8121,13975,2174,1003,1171,275,39,17,22,64063,12135,5001,7134,39987,2077,961,1116,916,109,7,102,14551,2815,1102,1713
1788,335155,21351,9642,11709,0500000US34023,34023,"Middlesex County, New Jersey",Middlesex County, New Jersey,79649,7764,3277,4487,37592,4018,2037,1981,374,36,0,36,172573,28516,11325,17191,194526,10561,4960,5601,2276,160,29,131,43995,8693,3437,5256
1789,461161,22354,9276,13078,0500000US34025,34025,"Monmouth County, New Jersey",Monmouth County, New Jersey,42213,5473,2209,3264,20859,1825,765,1060,101,0,0,0,66839,9968,4610,5358,33608,1158,544,614,945,85,35,50,15973,3647,1860,1787
1790,342855,13961,5832,8129,0500000US34027,34027,"Morris County, New Jersey",Morris County, New Jersey,15458,1709,838,871,18714,1266,606,660,82,13,0,13,65178,5442,2460,2982,51338,1521,680,841,634,167,95,72,12503,1085,571,514
1791,501775,48383,22080,26303,0500000US34029,34029,"Ocean County, New Jersey",Ocean County, New Jersey,17906,2133,912,1221,16485,1973,1226,747,169,113,30,83,55134,6314,2946,3368,11052,977,360,617,541,81,39,42,15268,2211,1001,1210
1792,201560,13403,6231,7172,0500000US34031,34031,"Passaic County, New Jersey",Passaic County, New Jersey,54188,10808,4900,5908,34632,7652,3565,4087,169,33,6,27,208462,45941,20445,25496,26759,2758,1604,1154,1501,673,339,334,77987,15323,6873,8450
1793,45277,3970,1658,2312,0500000US34033,34033,"Salem County, New Jersey",Salem County, New Jersey,8402,2227,1039,1188,1876,589,385,204,18,0,0,0,5811,1759,659,1100,540,75,43,32,252,45,0,45,1373,435,290,145
1794,179759,6278,2412,3866,0500000US34035,34035,"Somerset County, New Jersey",Somerset County, New Jersey,31733,2608,1221,1387,12035,753,325,428,47,15,0,15,48265,4080,1784,2296,60199,3054,1399,1655,1004,0,0,0,13227,1858,884,974
1795,119148,5789,2649,3140,0500000US34037,34037,"Sussex County, New Jersey",Sussex County, New Jersey,2999,343,208,135,4482,164,95,69,18,0,0,0,12084,922,543,379,2851,73,40,33,44,4,4,0,1619,107,92,15
1796,213997,9736,4343,5393,0500000US34039,34039,"Union County, New Jersey",Union County, New Jersey,116245,13844,6312,7532,29761,2644,1262,1382,65,15,15,0,175894,22057,10169,11888,29122,1355,659,696,1891,151,50,101,86544,12558,5613,6945
1797,84378,5165,2112,3053,0500000US34041,34041,"Warren County, New Jersey",Warren County, New Jersey,4703,921,545,376,4180,484,173,311,27,0,0,0,10103,1287,595,692,2760,140,91,49,110,5,5,0,1998,386,264,122
1798,253814,26950,12894,14056,0500000US35001,35001,"Bernalillo County, New Mexico",Bernalillo County, New Mexico,18285,3909,2139,1770,62402,9602,4751,4851,556,99,46,53,338176,66038,29937,36101,18084,1940,747,1193,30905,6772,3470,3302,68514,17218,7848,9370
1799,2892,699,277,422,0500000US35003,35003,"Catron County, New Mexico",Catron County, New Mexico,14,14,0,14,133,55,0,55,0,0,0,0,599,152,66,86,0,0,0,0,0,0,0,0,60,11,11,0
1800,23961,3371,1309,2062,0500000US35005,35005,"Chaves County, New Mexico",Chaves County, New Mexico,850,297,153,144,4822,840,236,604,0,0,0,0,36187,8119,3584,4535,562,42,24,18,931,370,186,184,4777,748,279,469
1801,4723,793,285,508,0500000US35006,35006,"Cibola County, New Mexico",Cibola County, New Mexico,255,16,6,10,1763,488,399,89,8,0,0,0,9653,2486,1319,1167,57,16,7,9,10763,3109,1343,1766,812,99,58,41
1802,5446,668,318,350,0500000US35007,35007,"Colfax County, New Mexico",Colfax County, New Mexico,60,4,4,0,601,152,44,108,0,0,0,0,5661,1760,856,904,38,0,0,0,278,58,12,46,768,147,70,77
1803,22733,2955,1355,1600,0500000US35009,35009,"Curry County, New Mexico",Curry County, New Mexico,2536,390,221,169,4068,1199,613,586,80,0,0,0,20784,5564,2495,3069,641,81,54,27,357,23,16,7,9065,2084,922,1162
1804,606,115,31,84,0500000US35011,35011,"De Baca County, New Mexico",De Baca County, New Mexico,85,0,0,0,344,0,0,0,0,0,0,0,1269,160,22,138,0,0,0,0,0,0,0,0,656,125,22,103
1805,56715,8455,3996,4459,0500000US35013,35013,"Doña Ana County, New Mexico",Doña Ana County, New Mexico,3692,687,447,240,18014,4322,2066,2256,190,0,0,0,146093,42110,18904,23206,2404,539,267,272,1866,475,204,271,19560,5471,2551,2920
1806,25906,2948,1363,1585,0500000US35015,35015,"Eddy County, New Mexico",Eddy County, New Mexico,837,43,17,26,3883,670,371,299,0,0,0,0,28538,5799,2750,3049,418,15,0,15,977,265,119,146,3153,622,215,407
1807,12140,2175,1104,1071,0500000US35017,35017,"Grant County, New Mexico",Grant County, New Mexico,142,14,14,0,2036,677,237,440,0,0,0,0,13351,3988,1545,2443,175,25,1,24,633,514,236,278,868,357,107,250
1808,616,171,102,69,0500000US35019,35019,"Guadalupe County, New Mexico",Guadalupe County, New Mexico,22,0,0,0,342,15,0,15,0,0,0,0,2711,394,247,147,0,0,0,0,298,5,0,5,244,99,84,15
1809,217,15,5,10,0500000US35021,35021,"Harding County, New Mexico",Harding County, New Mexico,0,0,0,0,10,0,0,0,16,0,0,0,172,37,14,23,0,0,0,0,0,0,0,0,112,16,7,9
1810,1531,233,93,140,0500000US35023,35023,"Hidalgo County, New Mexico",Hidalgo County, New Mexico,30,30,25,5,356,51,40,11,0,0,0,0,2453,635,330,305,0,0,0,0,54,10,10,0,129,4,2,2
1811,23387,2995,1335,1660,0500000US35025,35025,"Lea County, New Mexico",Lea County, New Mexico,2453,746,427,319,6047,331,214,117,0,0,0,0,40456,7261,3275,3986,394,0,0,0,613,75,35,40,3511,653,442,211
1812,11859,1356,647,709,0500000US35027,35027,"Lincoln County, New Mexico",Lincoln County, New Mexico,359,40,0,40,1400,515,58,457,0,0,0,0,6402,933,156,777,28,0,0,0,216,6,0,6,282,29,11,18
1813,13514,607,296,311,0500000US35028,35028,"Los Alamos County, New Mexico",Los Alamos County, New Mexico,143,3,3,0,1337,87,42,45,0,0,0,0,3418,87,42,45,933,42,24,18,159,0,0,0,402,0,0,0
1814,6823,1673,745,928,0500000US35029,35029,"Luna County, New Mexico",Luna County, New Mexico,343,168,122,46,2189,346,94,252,0,0,0,0,15971,3786,1560,2226,236,30,7,23,208,27,16,11,789,194,117,77
1815,5988,662,370,292,0500000US35031,35031,"McKinley County, New Mexico",McKinley County, New Mexico,338,44,33,11,3485,1189,753,436,120,64,64,0,10173,3298,1630,1668,797,88,32,56,53986,21658,10102,11556,3257,767,194,573
1816,764,109,35,74,0500000US35033,35033,"Mora County, New Mexico",Mora County, New Mexico,2,0,0,0,488,39,0,39,0,0,0,0,3658,829,436,393,0,0,0,0,24,5,2,3,1478,382,276,106
1817,30836,3840,1691,2149,0500000US35035,35035,"Otero County, New Mexico",Otero County, New Mexico,2031,368,95,273,5003,836,619,217,155,81,68,13,23818,6275,3066,3209,808,87,5,82,4391,1099,554,545,2755,875,376,499
1818,4024,769,407,362,0500000US35037,35037,"Quay County, New Mexico",Quay County, New Mexico,16,3,3,0,446,122,39,83,9,9,0,9,3688,815,280,535,86,13,2,11,182,73,49,24,778,258,117,141
1819,4632,822,306,516,0500000US35039,35039,"Rio Arriba County, New Mexico",Rio Arriba County, New Mexico,230,95,10,85,2983,628,321,307,7,0,0,0,27727,6397,2619,3778,234,180,0,180,6108,1587,790,797,10181,2469,875,1594
1820,9016,1353,621,732,0500000US35041,35041,"Roosevelt County, New Mexico",Roosevelt County, New Mexico,253,180,93,87,1195,322,150,172,24,0,0,0,7628,2333,1119,1214,47,16,8,8,150,56,0,56,2931,892,398,494
1821,61492,3986,1666,2320,0500000US35043,35043,"Sandoval County, New Mexico",Sandoval County, New Mexico,3468,455,322,133,12029,1082,481,601,261,0,0,0,56929,6988,3071,3917,2243,117,87,30,17614,5670,2795,2875,8761,1961,696,1265
1822,46291,5006,2600,2406,0500000US35045,35045,"San Juan County, New Mexico",San Juan County, New Mexico,944,86,50,36,6606,1719,591,1128,64,1,0,1,25923,5673,2706,2967,971,40,21,19,48163,15595,7209,8386,5895,1320,560,760
1823,4209,498,221,277,0500000US35047,35047,"San Miguel County, New Mexico",San Miguel County, New Mexico,193,27,1,26,1931,508,217,291,46,0,0,0,20802,6051,2797,3254,302,0,0,0,352,136,115,21,8016,2486,1183,1303
1824,63596,5459,2121,3338,0500000US35049,35049,"Santa Fe County, New Mexico",Santa Fe County, New Mexico,1503,308,139,169,10463,2223,1031,1192,240,90,90,0,75140,12490,6233,6257,1831,65,23,42,4754,786,319,467,11423,2582,1551,1031
1825,6668,1535,798,737,0500000US35051,35051,"Sierra County, New Mexico",Sierra County, New Mexico,15,1,0,1,695,34,1,33,0,0,0,0,3320,807,449,358,84,0,0,0,382,283,101,182,259,99,99,0
1826,5304,1008,537,471,0500000US35053,35053,"Socorro County, New Mexico",Socorro County, New Mexico,108,0,0,0,1253,664,362,302,0,0,0,0,8145,2624,1530,1094,354,31,24,7,2052,1282,640,642,457,100,84,16
1827,11497,1471,519,952,0500000US35055,35055,"Taos County, New Mexico",Taos County, New Mexico,84,41,14,27,2920,258,186,72,1,0,0,0,18502,3360,1768,1592,283,0,0,0,1926,706,324,382,1821,340,174,166
1828,7717,1364,761,603,0500000US35057,35057,"Torrance County, New Mexico",Torrance County, New Mexico,210,109,109,0,737,141,91,50,0,0,0,0,6565,1846,708,1138,191,170,23,147,178,35,35,0,1344,358,98,260
1829,1899,203,58,145,0500000US35059,35059,"Union County, New Mexico",Union County, New Mexico,3,0,0,0,300,81,0,81,0,0,0,0,1384,495,205,290,1,0,0,0,73,10,0,10,126,0,0,0
1830,24020,2363,1106,1257,0500000US35061,35061,"Valencia County, New Mexico",Valencia County, New Mexico,854,133,86,47,6313,1546,592,954,0,0,0,0,45596,9328,3605,5723,802,61,33,28,3055,555,235,320,6627,1900,657,1243
1831,208298,16323,7370,8953,0500000US36001,36001,"Albany County, New York",Albany County, New York,34845,9672,4381,5291,14614,3471,1475,1996,89,0,0,0,16849,4241,1972,2269,20057,2880,1329,1551,404,94,35,59,4045,1189,399,790
1832,39984,6576,2914,3662,0500000US36003,36003,"Allegany County, New York",Allegany County, New York,93,19,16,3,492,93,50,43,5,0,0,0,396,162,70,92,362,59,31,28,67,17,17,0,67,4,1,3
1833,119245,16496,7980,8516,0500000US36005,36005,"Bronx County, New York",Bronx County, New York,484642,126556,55665,70891,95142,24433,10052,14381,1773,434,184,250,787770,237628,98045,139583,54590,11720,5791,5929,9413,3468,1253,2215,453682,141754,59540,82214
1834,151767,22309,9713,12596,0500000US36007,36007,"Broome County, New York",Broome County, New York,9480,3948,1898,2050,7499,2180,1262,918,138,14,14,0,7697,2886,1496,1390,7674,3050,1306,1744,339,38,5,33,2362,1142,445,697
1835,67452,10419,4833,5586,0500000US36009,36009,"Cattaraugus County, New York",Cattaraugus County, New York,870,302,229,73,1813,499,236,263,0,0,0,0,1498,373,295,78,473,74,10,64,2406,916,369,547,374,82,61,21
1836,66795,7676,3173,4503,0500000US36011,36011,"Cayuga County, New York",Cayuga County, New York,1226,335,151,184,2538,520,267,253,51,0,0,0,1776,373,278,95,436,42,20,22,84,8,7,1,403,125,94,31
1837,107629,16519,7692,8827,0500000US36013,36013,"Chautauqua County, New York",Chautauqua County, New York,2331,983,444,539,3635,1181,445,736,44,0,0,0,9129,3163,1587,1576,594,110,56,54,321,139,28,111,2779,722,478,244
1838,69318,8668,3348,5320,0500000US36015,36015,"Chemung County, New York",Chemung County, New York,3704,1121,755,366,3417,1155,525,630,4,0,0,0,2272,736,352,384,1207,94,56,38,313,285,199,86,346,60,26,34
1839,44075,5432,2560,2872,0500000US36017,36017,"Chenango County, New York",Chenango County, New York,350,113,60,53,1046,281,112,169,17,5,0,5,1065,160,75,85,191,25,9,16,111,52,0,52,274,18,13,5
1840,68960,8098,3766,4332,0500000US36019,36019,"Clinton County, New York",Clinton County, New York,583,201,115,86,1520,324,56,268,8,0,0,0,962,290,90,200,747,118,56,62,131,65,56,9,381,73,54,19
1841,50454,4477,2215,2262,0500000US36021,36021,"Columbia County, New York",Columbia County, New York,1877,322,165,157,2181,286,74,212,0,0,0,0,2786,559,227,332,1066,298,157,141,53,5,0,5,1178,218,130,88
1842,40946,5505,2085,3420,0500000US36023,36023,"Cortland County, New York",Cortland County, New York,719,124,40,84,921,229,90,139,5,5,5,0,1190,527,273,254,345,27,24,3,56,0,0,0,296,119,54,65
1843,39389,5987,2611,3376,0500000US36025,36025,"Delaware County, New York",Delaware County, New York,475,144,84,60,1003,325,144,181,3,0,0,0,1545,447,174,273,325,67,28,39,53,6,0,6,357,160,95,65
1844,198518,13394,5737,7657,0500000US36027,36027,"Dutchess County, New York",Dutchess County, New York,27332,4380,1911,2469,13894,1549,720,829,102,17,17,0,34710,4804,2001,2803,9102,869,482,387,718,133,57,76,9533,1980,744,1236
1845,674214,57370,24591,32779,0500000US36029,36029,"Erie County, New York",Erie County, New York,114083,32697,14805,17892,29481,8838,4220,4618,247,144,68,76,49605,15284,6829,8455,32438,10448,5085,5363,4355,1060,438,622,18377,7339,2799,4540
1846,33223,3215,1428,1787,0500000US36031,36031,"Essex County, New York",Essex County, New York,123,62,28,34,609,119,65,54,19,3,3,0,590,143,97,46,92,5,0,5,73,29,5,24,275,30,27,3
1847,38807,6776,3080,3696,0500000US36033,36033,"Franklin County, New York",Franklin County, New York,643,286,157,129,1141,239,143,96,74,17,0,17,866,241,180,61,454,5,0,5,3102,508,140,368,300,11,5,6
1848,48108,6737,3207,3530,0500000US36035,36035,"Fulton County, New York",Fulton County, New York,679,294,133,161,1660,356,115,241,29,0,0,0,1677,447,123,324,390,17,17,0,202,27,0,27,341,68,51,17
1849,51256,4791,2054,2737,0500000US36037,36037,"Genesee County, New York",Genesee County, New York,1200,311,187,124,1861,513,212,301,0,0,0,0,1910,390,215,175,453,61,33,28,408,61,35,26,812,172,52,120
1850,38974,4092,1742,2350,0500000US36039,36039,"Greene County, New York",Greene County, New York,1170,433,237,196,1274,176,124,52,9,9,0,9,2318,272,173,99,474,17,14,3,315,168,87,81,564,63,26,37
1851,4166,337,154,183,0500000US36041,36041,"Hamilton County, New York",Hamilton County, New York,13,7,3,4,175,9,3,6,0,0,0,0,76,27,21,6,2,2,0,2,16,1,0,1,8,0,0,0
1852,56903,7359,3286,4073,0500000US36043,36043,"Herkimer County, New York",Herkimer County, New York,781,169,53,116,1535,311,205,106,54,0,0,0,1352,273,140,133,290,59,42,17,76,35,30,5,329,132,13,119
1853,87443,11095,4803,6292,0500000US36045,36045,"Jefferson County, New York",Jefferson County, New York,4938,1061,710,351,4773,1097,425,672,236,30,0,30,7153,1712,904,808,1598,404,168,236,367,96,66,30,1066,247,88,159
1854,929900,153566,72004,81562,0500000US36047,36047,"Kings County, New York",Kings County, New York,797321,156342,64266,92076,119869,21069,9020,12049,1360,453,120,333,481616,123345,50807,72538,303942,57131,27543,29588,8577,2290,916,1374,227081,63600,26924,36676
1855,25066,3242,1447,1795,0500000US36049,36049,"Lewis County, New York",Lewis County, New York,179,56,11,45,346,101,31,70,0,0,0,0,442,113,1,112,67,1,1,0,49,8,2,6,195,39,1,38
1856,52869,6058,2614,3444,0500000US36051,36051,"Livingston County, New York",Livingston County, New York,828,308,163,145,1400,196,71,125,53,0,0,0,1760,582,298,284,602,137,25,112,117,48,27,21,664,244,144,100
1857,62044,5174,2533,2641,0500000US36053,36053,"Madison County, New York",Madison County, New York,476,136,80,56,1780,139,83,56,60,60,36,24,1212,46,15,31,218,5,0,5,404,19,8,11,311,20,0,20
1858,502970,39720,17149,22571,0500000US36055,36055,"Monroe County, New York",Monroe County, New York,108034,34152,15473,18679,29463,7636,3500,4136,461,158,80,78,65479,20195,8843,11352,25529,3797,1718,2079,2190,635,277,358,15329,4204,1870,2334
1859,38731,5375,2310,3065,0500000US36057,36057,"Montgomery County, New York",Montgomery County, New York,1313,554,363,191,1856,661,335,326,12,0,0,0,7142,2359,1150,1209,327,105,55,50,79,18,3,15,2940,1233,515,718
1860,789076,29470,12242,17228,0500000US36059,36059,"Nassau County, New York",Nassau County, New York,153412,11432,4987,6445,58493,4378,1659,2719,342,10,10,0,227125,22493,9328,13165,138325,6201,2851,3350,3430,560,242,318,94687,12707,5269,7438
1861,741128,50424,21430,28994,0500000US36061,36061,"New York County, New York",New York County, New York,225306,63802,28405,35397,98810,17123,7742,9381,702,245,97,148,409509,100509,41676,58833,190902,33766,14479,19287,6576,1664,1010,654,187796,52376,21808,30568
1862,175322,16573,7143,9430,0500000US36063,36063,"Niagara County, New York",Niagara County, New York,13844,4606,2218,2388,7528,1850,999,851,97,61,8,53,6514,1903,850,1053,1831,325,111,214,1915,536,266,270,2149,632,299,333
1863,179074,18436,8211,10225,0500000US36065,36065,"Oneida County, New York",Oneida County, New York,11449,5108,2302,2806,7623,2176,1301,875,15,0,0,0,12426,3151,1349,1802,9283,2383,1064,1319,413,128,101,27,3479,1303,415,888
1864,340847,30570,13593,16977,0500000US36067,36067,"Onondaga County, New York",Onondaga County, New York,48611,18290,7966,10324,20442,5110,2186,2924,146,24,17,7,22013,6312,2754,3558,15065,2713,1402,1311,2075,546,271,275,4802,1318,546,772
1865,95867,7665,3545,4120,0500000US36069,36069,"Ontario County, New York",Ontario County, New York,2246,489,299,190,2659,552,327,225,27,0,0,0,4991,1139,659,480,1320,20,20,0,277,43,19,24,1532,394,205,189
1866,235454,25629,11809,13820,0500000US36071,36071,"Orange County, New York",Orange County, New York,40031,4449,2000,2449,20628,2500,975,1525,267,73,10,63,78457,9895,4082,5813,10575,1269,533,736,1419,95,59,36,28788,4672,1948,2724
1867,33513,4113,1764,2349,0500000US36073,36073,"Orleans County, New York",Orleans County, New York,1374,303,104,199,1086,126,32,94,0,0,0,0,1773,669,260,409,246,11,7,4,124,30,25,5,682,506,167,339
1868,106369,16997,7712,9285,0500000US36075,36075,"Oswego County, New York",Oswego County, New York,786,313,186,127,2663,648,311,337,20,12,12,0,2374,982,524,458,593,20,11,9,91,40,25,15,446,246,130,116
1869,50472,6381,2584,3797,0500000US36077,36077,"Otsego County, New York",Otsego County, New York,852,301,131,170,1374,257,122,135,70,3,0,3,1666,383,122,261,552,27,0,27,43,3,3,0,271,125,36,89
1870,75825,3515,1622,1893,0500000US36079,36079,"Putnam County, New York",Putnam County, New York,3133,244,184,60,2988,169,137,32,13,13,7,6,14993,1261,637,624,2054,336,103,233,242,50,18,32,6028,588,300,288
1871,551855,45585,20109,25476,0500000US36081,36081,"Queens County, New York",Queens County, New York,401447,42263,17885,24378,132568,16725,7449,9276,1116,151,57,94,624328,84949,36843,48106,585567,78735,35255,43480,10558,1214,626,588,309044,41766,17895,23871
1872,127448,10453,4515,5938,0500000US36083,36083,"Rensselaer County, New York",Rensselaer County, New York,9573,2487,991,1496,6859,1760,866,894,14,2,0,2,7811,1966,837,1129,3388,428,158,270,184,28,13,15,2106,535,158,377
1873,283002,19294,8351,10943,0500000US36085,36085,"Richmond County, New York",Richmond County, New York,47710,11274,4268,7006,19144,2583,1188,1395,141,28,18,10,86835,15660,6814,8846,47274,4658,2109,2549,1108,10,2,8,18195,4532,2126,2406
1874,202799,32590,16439,16151,0500000US36087,36087,"Rockland County, New York",Rockland County, New York,38545,4203,1644,2559,12019,1637,730,907,17,0,0,0,56759,9616,4522,5094,19334,597,374,223,587,58,40,18,25221,4817,2422,2395
1875,91937,15864,7582,8282,0500000US36089,36089,"St. Lawrence County, New York",St. Lawrence County, New York,353,159,105,54,2099,556,337,219,54,17,0,17,1229,261,121,140,703,86,31,55,613,143,50,93,229,74,25,49
1876,203712,11878,4577,7301,0500000US36091,36091,"Saratoga County, New York",Saratoga County, New York,3661,539,222,317,5731,418,128,290,18,0,0,0,7339,558,235,323,6400,126,70,56,474,26,0,26,1025,50,45,5
1877,108824,7900,3086,4814,0500000US36093,36093,"Schenectady County, New York",Schenectady County, New York,15039,4112,1724,2388,9145,1978,917,1061,50,24,0,24,11136,3238,1846,1392,6997,493,228,265,393,87,56,31,5290,1432,743,689
1878,27888,3041,1302,1739,0500000US36095,36095,"Schoharie County, New York",Schoharie County, New York,236,55,26,29,729,187,35,152,9,2,0,2,848,114,54,60,253,71,32,39,62,27,0,27,175,19,10,9
1879,16723,2361,1067,1294,0500000US36097,36097,"Schuyler County, New York",Schuyler County, New York,110,14,8,6,289,35,10,25,0,0,0,0,312,118,60,58,129,43,19,24,24,18,0,18,41,4,0,4
1880,29107,3169,1453,1716,0500000US36099,36099,"Seneca County, New York",Seneca County, New York,455,140,85,55,732,136,26,110,7,0,0,0,835,306,93,213,240,106,31,75,110,27,18,9,135,11,3,8
1881,87880,10656,5101,5555,0500000US36101,36101,"Steuben County, New York",Steuben County, New York,1428,488,362,126,1860,471,239,232,0,0,0,0,1527,454,255,199,1488,44,36,8,132,25,7,18,577,142,106,36
1882,979801,45518,19264,26254,0500000US36103,36103,"Suffolk County, New York",Suffolk County, New York,110432,11758,5293,6465,60023,6071,2590,3481,508,23,5,18,285004,31030,13158,17872,56282,3879,1848,2031,4057,473,231,242,76273,8711,3775,4936
1883,52213,5444,2410,3034,0500000US36105,36105,"Sullivan County, New York",Sullivan County, New York,5272,1471,499,972,3967,695,301,394,6,6,0,6,11711,2140,789,1351,1219,67,36,31,127,37,4,33,4450,1220,613,607
1884,45402,4234,1703,2531,0500000US36107,36107,"Tioga County, New York",Tioga County, New York,383,132,92,40,811,121,82,39,7,7,7,0,928,227,122,105,411,33,5,28,88,12,0,12,269,147,82,65
1885,69562,9342,4167,5175,0500000US36109,36109,"Tompkins County, New York",Tompkins County, New York,2891,1183,513,670,4524,1214,806,408,40,21,21,0,3700,1159,518,641,8577,2891,1454,1437,63,3,1,2,1029,382,221,161
1886,133648,14783,6745,8038,0500000US36111,36111,"Ulster County, New York",Ulster County, New York,8884,2372,1219,1153,11479,2088,833,1255,11,0,0,0,16868,4828,2167,2661,2973,571,293,278,261,35,16,19,5069,1649,851,798
1887,59314,4602,2114,2488,0500000US36113,36113,"Warren County, New York",Warren County, New York,591,77,51,26,1234,309,191,118,30,30,30,0,1667,263,112,151,531,79,57,22,93,0,0,0,230,65,21,44
1888,54895,5671,2375,3296,0500000US36115,36115,"Washington County, New York",Washington County, New York,368,80,76,4,1367,394,216,178,23,0,0,0,977,70,52,18,317,29,0,29,174,104,59,45,354,21,14,7
1889,79582,7683,3200,4483,0500000US36117,36117,"Wayne County, New York",Wayne County, New York,2098,795,305,490,3269,695,447,248,4,0,0,0,4006,836,562,274,756,107,65,42,114,50,0,50,1085,116,87,29
1890,499935,23472,9362,14110,0500000US36119,36119,"Westchester County, New York",Westchester County, New York,137008,20373,8249,12124,49236,4359,1489,2870,277,12,0,12,236085,31159,13227,17932,58929,3814,1612,2202,3348,419,97,322,111180,16916,7556,9360
1891,35096,2832,1188,1644,0500000US36121,36121,"Wyoming County, New York",Wyoming County, New York,723,130,114,16,646,46,9,37,0,0,0,0,790,246,56,190,182,2,0,2,77,15,6,9,381,73,34,39
1892,22633,2901,1413,1488,0500000US36123,36123,"Yates County, New York",Yates County, New York,152,67,12,55,323,91,15,76,7,0,0,0,506,155,40,115,111,0,0,0,26,4,0,4,206,104,25,79
1893,101497,10701,4320,6381,0500000US37001,37001,"Alamance County, North Carolina",Alamance County, North Carolina,32224,8034,3164,4870,5127,1135,640,495,54,3,0,3,20784,5054,2290,2764,2474,496,280,216,681,90,68,22,10012,1869,918,951
1894,31602,2919,1217,1702,0500000US37003,37003,"Alexander County, North Carolina",Alexander County, North Carolina,1264,395,212,183,728,356,155,201,0,0,0,0,1753,633,342,291,394,128,32,96,288,0,0,0,1178,510,254,256
1895,9544,1708,634,1074,0500000US37005,37005,"Alleghany County, North Carolina",Alleghany County, North Carolina,160,114,73,41,243,43,5,38,1,1,0,1,1075,622,329,293,42,3,0,3,50,0,0,0,31,8,5,3
1896,10306,859,323,536,0500000US37007,37007,"Anson County, North Carolina",Anson County, North Carolina,11129,3177,1280,1897,273,108,71,37,0,0,0,0,966,103,81,22,260,12,7,5,56,5,0,5,69,0,0,0
1897,24699,3412,1549,1863,0500000US37009,37009,"Ashe County, North Carolina",Ashe County, North Carolina,172,65,50,15,516,81,16,65,15,15,0,15,1349,407,274,133,152,1,0,1,68,12,0,12,149,6,6,0
1898,13172,1580,782,798,0500000US37011,37011,"Avery County, North Carolina",Avery County, North Carolina,31,13,10,3,113,4,0,4,4,4,0,4,709,208,82,126,39,4,1,3,73,30,26,4,113,90,36,54
1899,30677,3733,1579,2154,0500000US37013,37013,"Beaufort County, North Carolina",Beaufort County, North Carolina,11480,3172,1382,1790,1123,322,109,213,0,0,0,0,3531,1114,450,664,48,11,0,11,63,62,2,60,505,46,8,38
1900,6176,523,169,354,0500000US37015,37015,"Bertie County, North Carolina",Bertie County, North Carolina,11019,3836,1596,2240,250,18,7,11,1,0,0,0,306,141,94,47,119,0,0,0,4,0,0,0,67,47,0,47
1901,17976,2543,1159,1384,0500000US37017,37017,"Bladen County, North Carolina",Bladen County, North Carolina,11354,4481,2047,2434,198,42,0,42,0,0,0,0,2489,866,448,418,52,0,0,0,865,162,49,113,1337,402,222,180
1902,111102,10083,4130,5953,0500000US37019,37019,"Brunswick County, North Carolina",Brunswick County, North Carolina,12681,2135,779,1356,4728,1040,435,605,3,0,0,0,6645,1854,903,951,725,134,25,109,823,39,2,37,2915,351,100,251
1903,211001,19840,9414,10426,0500000US37021,37021,"Buncombe County, North Carolina",Buncombe County, North Carolina,15347,2813,1226,1587,7550,1772,618,1154,337,0,0,0,17035,5268,2374,2894,3199,183,75,108,783,60,40,20,3174,963,438,525
1904,71927,11940,5552,6388,0500000US37023,37023,"Burke County, North Carolina",Burke County, North Carolina,4658,979,580,399,1678,606,350,256,109,56,56,0,5431,1832,912,920,3337,489,164,325,813,242,130,112,2870,1472,604,868
1905,134518,8821,3227,5594,0500000US37025,37025,"Cabarrus County, North Carolina",Cabarrus County, North Carolina,38906,4882,1925,2957,6914,1315,576,739,153,3,0,3,22314,4980,2035,2945,8775,242,153,89,665,190,190,0,9074,3111,1383,1728
1906,70317,8915,3955,4960,0500000US37027,37027,"Caldwell County, North Carolina",Caldwell County, North Carolina,3316,1087,631,456,2260,308,216,92,81,0,0,0,4648,1017,406,611,428,0,0,0,194,56,34,22,3024,794,292,502
1907,8536,629,293,336,0500000US37029,37029,"Camden County, North Carolina",Camden County, North Carolina,1181,26,4,22,436,20,2,18,57,0,0,0,325,2,2,0,195,0,0,0,24,0,0,0,40,0,0,0
1908,58811,4828,1969,2859,0500000US37031,37031,"Carteret County, North Carolina",Carteret County, North Carolina,3164,702,223,479,2474,351,119,232,38,0,0,0,2938,366,171,195,767,54,17,37,195,18,5,13,604,5,0,5
1909,13155,1506,783,723,0500000US37033,37033,"Caswell County, North Carolina",Caswell County, North Carolina,6850,1500,804,696,256,32,32,0,14,0,0,0,917,432,219,213,204,0,0,0,49,0,0,0,410,185,83,102
1910,116770,10678,4689,5989,0500000US37035,37035,"Catawba County, North Carolina",Catawba County, North Carolina,12191,3013,1153,1860,4694,468,226,242,0,0,0,0,15556,4090,1797,2293,6985,969,467,502,617,177,81,96,8440,2325,1076,1249
1911,51783,3258,1170,2088,0500000US37037,37037,"Chatham County, North Carolina",Chatham County, North Carolina,8419,1974,959,1015,2650,649,277,372,0,0,0,0,8736,2158,1088,1070,1182,16,2,14,130,93,46,47,2591,549,309,240
1912,25465,4468,2179,2289,0500000US37039,37039,"Cherokee County, North Carolina",Cherokee County, North Carolina,307,129,47,82,573,62,25,37,16,0,0,0,974,248,73,175,219,1,0,1,474,96,49,47,311,31,0,31
1913,8211,1000,406,594,0500000US37041,37041,"Chowan County, North Carolina",Chowan County, North Carolina,4728,1535,476,1059,285,137,85,52,0,0,0,0,468,15,0,15,68,15,0,15,65,0,0,0,292,0,0,0
1914,10358,1286,474,812,0500000US37043,37043,"Clay County, North Carolina",Clay County, North Carolina,204,115,72,43,39,21,18,3,44,44,0,44,383,37,11,26,20,0,0,0,58,0,0,0,15,0,0,0
1915,69206,10896,4157,6739,0500000US37045,37045,"Cleveland County, North Carolina",Cleveland County, North Carolina,20034,6075,2581,3494,1680,286,175,111,125,45,45,0,3572,938,438,500,965,50,43,7,235,0,0,0,1977,510,189,321
1916,31920,5309,2460,2849,0500000US37047,37047,"Columbus County, North Carolina",Columbus County, North Carolina,15081,4672,2059,2613,883,313,136,177,10,9,0,9,2824,928,451,477,196,34,0,34,1728,394,208,186,999,145,85,60
1917,63734,5585,2362,3223,0500000US37049,37049,"Craven County, North Carolina",Craven County, North Carolina,20630,4760,2122,2638,2778,871,398,473,124,0,0,0,6630,1875,919,956,2825,896,480,416,533,201,90,111,2326,416,272,144
1918,133314,17540,7573,9967,0500000US37051,37051,"Cumberland County, North Carolina",Cumberland County, North Carolina,120312,28593,12171,16422,22084,4932,2283,2649,1057,258,134,124,37321,7778,3379,4399,8212,1162,478,684,3946,1146,355,791,9426,2260,972,1288
1919,23494,1723,700,1023,0500000US37053,37053,"Currituck County, North Carolina",Currituck County, North Carolina,1475,230,139,91,888,58,27,31,18,18,0,18,1102,94,0,94,111,24,0,24,93,71,0,71,318,62,0,62
1920,31776,2077,958,1119,0500000US37055,37055,"Dare County, North Carolina",Dare County, North Carolina,1197,461,347,114,1052,57,0,57,14,0,0,0,2629,588,387,201,199,0,0,0,47,0,0,0,705,108,84,24
1921,131071,16486,6867,9619,0500000US37057,37057,"Davidson County, North Carolina",Davidson County, North Carolina,15283,3425,1527,1898,4714,1146,519,627,0,0,0,0,12149,3599,1733,1866,2572,350,98,252,409,192,97,95,2216,365,124,241
1922,35610,4065,1649,2416,0500000US37059,37059,"Davie County, North Carolina",Davie County, North Carolina,1965,331,223,108,1747,434,260,174,0,0,0,0,2940,917,309,608,295,0,0,0,267,52,40,12,487,81,41,40
1923,29948,3728,1634,2094,0500000US37061,37061,"Duplin County, North Carolina",Duplin County, North Carolina,13413,3244,1239,2005,1936,413,114,299,48,0,0,0,13202,3503,1610,1893,184,6,3,3,222,0,0,0,2271,301,159,142
1924,129812,8871,4123,4748,0500000US37063,37063,"Durham County, North Carolina",Durham County, North Carolina,107053,17694,8103,9591,15161,3329,1041,2288,131,27,9,18,41795,10067,4760,5307,14753,2394,1104,1290,765,88,42,46,10311,1811,849,962
1925,18343,2477,989,1488,0500000US37065,37065,"Edgecombe County, North Carolina",Edgecombe County, North Carolina,29598,8102,3424,4678,836,220,119,101,27,0,0,0,2503,667,242,425,84,7,3,4,176,25,25,0,515,200,94,106
1926,207622,18991,7779,11212,0500000US37067,37067,"Forsyth County, North Carolina",Forsyth County, North Carolina,93996,22023,9021,13002,16064,3719,1885,1834,244,167,57,110,48927,14833,6901,7932,8435,749,242,507,1310,321,129,192,9684,2232,981,1251
1927,42309,3503,1347,2156,0500000US37069,37069,"Franklin County, North Carolina",Franklin County, North Carolina,15601,2433,1045,1388,3045,696,440,256,97,0,0,0,5831,1286,745,541,311,40,0,40,644,119,68,51,2138,363,205,158
1928,156348,18097,7728,10369,0500000US37071,37071,"Gaston County, North Carolina",Gaston County, North Carolina,36175,6799,2700,4099,8078,1911,872,1039,144,0,0,0,15969,3634,1629,2005,3759,134,36,98,654,113,76,37,3972,831,285,546
1929,7223,511,202,309,0500000US37073,37073,"Gates County, North Carolina",Gates County, North Carolina,3604,976,459,517,334,0,0,0,0,0,0,0,11,0,0,0,178,0,0,0,93,0,0,0,3,0,0,0
1930,7219,882,336,546,0500000US37075,37075,"Graham County, North Carolina",Graham County, North Carolina,3,3,2,1,67,30,15,15,0,0,0,0,316,175,73,102,0,0,0,0,764,79,61,18,209,142,70,72
1931,33201,2942,1360,1582,0500000US37077,37077,"Granville County, North Carolina",Granville County, North Carolina,16035,3698,1923,1775,2729,490,188,302,236,83,0,83,4732,764,279,485,324,36,10,26,160,77,15,62,2383,410,124,286
1932,8979,1103,420,683,0500000US37079,37079,"Greene County, North Carolina",Greene County, North Carolina,5899,1671,909,762,1121,161,41,120,0,0,0,0,2986,1078,552,526,0,0,0,0,24,0,0,0,531,129,73,56
1933,256531,21068,8527,12541,0500000US37081,37081,"Guilford County, North Carolina",Guilford County, North Carolina,172542,39837,16550,23287,17769,3419,1162,2257,194,148,60,88,42170,10701,4673,6028,27185,3898,1709,2189,2492,696,281,415,13360,3540,1413,2127
1934,18818,2819,1385,1434,0500000US37083,37083,"Halifax County, North Carolina",Halifax County, North Carolina,25797,8579,3539,5040,1491,346,180,166,98,21,14,7,1436,253,212,41,363,15,7,8,1764,641,313,328,313,2,0,2
1935,79688,10209,4494,5715,0500000US37085,37085,"Harnett County, North Carolina",Harnett County, North Carolina,27515,6247,2785,3462,5823,1052,571,481,364,0,0,0,17173,3222,1262,1960,1797,268,62,206,1215,287,123,164,6763,1099,413,686
1936,56359,6182,2782,3400,0500000US37087,37087,"Haywood County, North Carolina",Haywood County, North Carolina,534,202,178,24,1505,160,51,109,0,0,0,0,2557,846,314,532,468,81,20,61,326,30,22,8,540,380,153,227
1937,95432,8171,3268,4903,0500000US37089,37089,"Henderson County, North Carolina",Henderson County, North Carolina,3963,733,253,480,2846,954,400,554,0,0,0,0,11634,2726,1174,1552,1618,118,16,102,322,1,0,1,1826,592,230,362
1938,7320,812,369,443,0500000US37091,37091,"Hertford County, North Carolina",Hertford County, North Carolina,13059,3161,1329,1832,377,170,55,115,6,0,0,0,500,211,118,93,184,51,8,43,272,113,47,66,113,44,41,3
1939,20925,2518,1154,1364,0500000US37093,37093,"Hoke County, North Carolina",Hoke County, North Carolina,17346,3506,1694,1812,3414,653,299,354,97,24,16,8,7376,2294,1058,1236,775,27,5,22,4087,1180,460,720,3466,1263,561,702
1940,2634,478,190,288,0500000US37095,37095,"Hyde County, North Carolina",Hyde County, North Carolina,1184,463,297,166,235,46,44,2,0,0,0,0,640,4,4,0,0,0,0,0,0,0,0,0,97,0,0,0
1941,134046,9745,4145,5600,0500000US37097,37097,"Iredell County, North Carolina",Iredell County, North Carolina,21327,4267,1999,2268,5183,671,440,231,135,0,0,0,13658,2639,944,1695,4365,130,68,62,539,137,0,137,3724,636,219,417
1942,31753,4820,2303,2517,0500000US37099,37099,"Jackson County, North Carolina",Jackson County, North Carolina,523,259,140,119,1617,665,304,361,0,0,0,0,2474,944,332,612,269,246,98,148,3208,464,265,199,1175,478,249,229
1943,134915,10011,4426,5585,0500000US37101,37101,"Johnston County, North Carolina",Johnston County, North Carolina,31976,5480,2230,3250,7672,1761,823,938,4,0,0,0,27855,8400,4334,4066,1311,135,80,55,949,66,4,62,7927,2734,1453,1281
1944,5848,1060,588,472,0500000US37103,37103,"Jones County, North Carolina",Jones County, North Carolina,2769,874,453,421,314,100,77,23,0,0,0,0,480,140,57,83,35,0,0,0,89,27,0,27,143,3,2,1
1945,34756,3666,1662,2004,0500000US37105,37105,"Lee County, North Carolina",Lee County, North Carolina,11610,3107,1343,1764,2212,479,249,230,0,0,0,0,11531,2655,1230,1425,886,0,0,0,412,285,27,258,1233,381,129,252
1946,26973,3485,1165,2320,0500000US37107,37107,"Lenoir County, North Carolina",Lenoir County, North Carolina,21423,6169,2863,3306,2588,1097,430,667,50,0,0,0,4393,1593,875,718,117,12,0,12,107,46,10,36,1628,415,129,286
1947,70642,7670,3787,3883,0500000US37109,37109,"Lincoln County, North Carolina",Lincoln County, North Carolina,4029,1161,411,750,2802,477,247,230,42,0,0,0,6075,899,436,463,702,8,0,8,143,0,0,0,1619,303,163,140
1948,39032,5308,2202,3106,0500000US37111,37111,"McDowell County, North Carolina",McDowell County, North Carolina,1296,606,490,116,1018,509,265,244,0,0,0,0,2748,751,391,360,465,0,0,0,64,17,6,11,929,317,188,129
1949,31037,4430,1718,2712,0500000US37113,37113,"Macon County, North Carolina",Macon County, North Carolina,508,173,146,27,455,132,4,128,0,0,0,0,2481,856,434,422,326,9,4,5,224,24,24,0,833,257,172,85
1950,19570,2800,1322,1478,0500000US37115,37115,"Madison County, North Carolina",Madison County, North Carolina,101,36,4,32,498,39,5,34,0,0,0,0,490,19,0,19,84,4,0,4,57,18,18,0,80,42,8,34
1951,11590,1663,693,970,0500000US37117,37117,"Martin County, North Carolina",Martin County, North Carolina,9311,2153,836,1317,705,470,117,353,0,0,0,0,942,686,274,412,145,9,0,9,67,26,26,0,72,0,0,0
1952,498933,30269,13263,17006,0500000US37119,37119,"Mecklenburg County, North Carolina",Mecklenburg County, North Carolina,340280,47419,19797,27622,42647,5271,2156,3115,404,40,32,8,144747,29629,12496,17133,65908,6686,3570,3116,3704,870,430,440,65315,16531,6583,9948
1953,13406,1469,619,850,0500000US37121,37121,"Mitchell County, North Carolina",Mitchell County, North Carolina,5,5,5,0,386,96,60,36,0,0,0,0,848,262,114,148,18,11,0,11,77,29,29,0,102,27,10,17
1954,16683,2167,890,1277,0500000US37123,37123,"Montgomery County, North Carolina",Montgomery County, North Carolina,4346,1178,520,658,564,261,67,194,0,0,0,0,4080,704,259,445,419,53,14,39,87,40,22,18,794,214,26,188
1955,75377,5629,2215,3414,0500000US37125,37125,"Moore County, North Carolina",Moore County, North Carolina,10686,2747,1221,1526,3196,677,388,289,236,0,0,0,6769,1660,685,975,1357,94,0,94,750,93,36,57,2002,151,73,78
1956,45707,4405,1818,2587,0500000US37127,37127,"Nash County, North Carolina",Nash County, North Carolina,37081,7845,3186,4659,2104,337,256,81,27,0,0,0,6525,1847,966,881,853,22,0,22,499,91,70,21,3887,1233,712,521
1957,173214,18952,8267,10685,0500000US37129,37129,"New Hanover County, North Carolina",New Hanover County, North Carolina,29618,9672,4022,5650,5980,1261,755,506,205,194,113,81,12726,2860,1417,1443,2996,390,202,188,432,67,22,45,3834,535,230,305
1958,7308,782,418,364,0500000US37131,37131,"Northampton County, North Carolina",Northampton County, North Carolina,10438,2546,905,1641,550,181,41,140,0,0,0,0,419,210,94,116,28,26,0,26,80,42,22,20,243,115,55,60
1959,118912,12512,5159,7353,0500000US37133,37133,"Onslow County, North Carolina",Onslow County, North Carolina,25544,5144,2031,3113,13766,2016,974,1042,200,39,27,12,20394,2496,1237,1259,3172,310,50,260,788,117,23,94,2738,196,55,141
1960,93515,9896,3752,6144,0500000US37135,37135,"Orange County, North Carolina",Orange County, North Carolina,14728,2471,1192,1279,4835,732,200,532,1,0,0,0,11629,2221,733,1488,10456,1373,556,817,689,47,14,33,2284,307,123,184
1961,9155,1050,566,484,0500000US37137,37137,"Pamlico County, North Carolina",Pamlico County, North Carolina,2006,606,301,305,368,49,34,15,2,0,0,0,484,161,77,84,61,0,0,0,24,2,2,0,125,68,38,30
1962,20599,1406,671,735,0500000US37139,37139,"Pasquotank County, North Carolina",Pasquotank County, North Carolina,12793,2534,1147,1387,1616,420,185,235,0,0,0,0,2157,478,167,311,440,0,0,0,60,0,0,0,270,57,42,15
1963,45738,4155,1848,2307,0500000US37141,37141,"Pender County, North Carolina",Pender County, North Carolina,8323,2291,999,1292,1521,275,121,154,74,19,19,0,4498,1641,944,697,321,112,73,39,147,22,22,0,3002,1125,643,482
1964,9716,422,212,210,0500000US37143,37143,"Perquimans County, North Carolina",Perquimans County, North Carolina,3148,1139,536,603,137,10,0,10,0,0,0,0,369,41,10,31,63,54,28,26,27,0,0,0,121,0,0,0
1965,25865,3020,1138,1882,0500000US37145,37145,"Person County, North Carolina",Person County, North Carolina,9939,2275,1142,1133,1609,190,30,160,1,0,0,0,1751,1022,236,786,150,0,0,0,242,93,2,91,914,647,216,431
1966,92707,14075,5612,8463,0500000US37147,37147,"Pitt County, North Carolina",Pitt County, North Carolina,60758,18081,7198,10883,4957,1045,509,536,81,0,0,0,11285,2316,939,1377,3093,246,85,161,577,192,56,136,6755,1649,736,913
1967,17723,1631,579,1052,0500000US37149,37149,"Polk County, North Carolina",Polk County, North Carolina,925,38,19,19,385,50,0,50,4,0,0,0,1227,295,97,198,153,7,0,7,75,75,49,26,301,76,32,44
1968,111560,13459,5691,7768,0500000US37151,37151,"Randolph County, North Carolina",Randolph County, North Carolina,8493,2274,985,1289,4344,1074,493,581,95,0,0,0,16673,3952,1817,2135,1763,259,88,171,435,85,31,54,7160,1858,731,1127
1969,24731,3988,1886,2102,0500000US37153,37153,"Richmond County, North Carolina",Richmond County, North Carolina,13610,4439,1718,2721,1072,247,88,159,52,0,0,0,2910,615,365,250,393,53,8,45,1150,450,293,157,586,12,0,12
1970,31161,5317,2346,2971,0500000US37155,37155,"Robeson County, North Carolina",Robeson County, North Carolina,29737,9881,4239,5642,2786,518,268,250,33,0,0,0,11493,4932,2442,2490,740,88,46,42,52729,14006,6182,7824,7684,3190,1553,1637
1971,64751,9284,4203,5081,0500000US37157,37157,"Rockingham County, North Carolina",Rockingham County, North Carolina,15769,3761,1587,2174,2889,755,426,329,16,1,0,1,5603,2249,1186,1063,639,39,22,17,473,4,4,0,2265,1567,833,734
1972,99306,11881,5409,6472,0500000US37159,37159,"Rowan County, North Carolina",Rowan County, North Carolina,21062,5282,2248,3034,4093,1068,447,621,5,0,0,0,12588,4536,2434,2102,1402,97,0,97,771,155,84,71,3990,1263,677,586
1973,54348,8218,3037,5181,0500000US37161,37161,"Rutherford County, North Carolina",Rutherford County, North Carolina,5892,2211,1138,1073,1850,628,131,497,19,1,1,0,3007,646,254,392,345,48,0,48,212,18,14,4,895,173,62,111
1974,31692,4417,1924,2493,0500000US37163,37163,"Sampson County, North Carolina",Sampson County, North Carolina,15767,5028,2193,2835,2064,448,189,259,0,0,0,0,12553,3652,1708,1944,369,63,26,37,1302,321,172,149,4901,606,172,434
1975,14027,2378,1072,1306,0500000US37165,37165,"Scotland County, North Carolina",Scotland County, North Carolina,12580,5135,2117,3018,1023,444,230,214,0,0,0,0,1034,238,167,71,209,17,0,17,4045,897,474,423,693,35,21,14
1976,48824,3922,1268,2654,0500000US37167,37167,"Stanly County, North Carolina",Stanly County, North Carolina,6630,2739,1099,1640,1285,283,138,145,0,0,0,0,2549,384,190,194,1058,7,0,7,311,71,41,30,434,133,48,85
1977,40858,4939,1952,2987,0500000US37169,37169,"Stokes County, North Carolina",Stokes County, North Carolina,1731,266,198,68,616,243,73,170,0,0,0,0,1485,636,134,502,175,0,0,0,235,67,0,67,446,155,30,125
1978,59149,8883,3832,5051,0500000US37171,37171,"Surry County, North Carolina",Surry County, North Carolina,2575,769,347,422,1653,202,91,111,125,91,29,62,7817,1754,845,909,458,23,23,0,238,33,21,12,2520,655,390,265
1979,8549,1365,549,816,0500000US37173,37173,"Swain County, North Carolina",Swain County, North Carolina,64,38,32,6,478,304,133,171,7,0,0,0,858,170,170,0,64,42,0,42,4294,551,248,303,70,52,52,0
1980,29935,3904,1729,2175,0500000US37175,37175,"Transylvania County, North Carolina",Transylvania County, North Carolina,1286,491,232,259,672,36,34,2,1,0,0,0,1080,315,130,185,53,0,0,0,118,0,0,0,532,194,59,135
1981,1951,163,53,110,0500000US37177,37177,"Tyrrell County, North Carolina",Tyrrell County, North Carolina,996,342,150,192,69,44,19,25,0,0,0,0,164,48,33,15,19,0,0,0,13,13,13,0,81,0,0,0
1982,166724,8726,3680,5046,0500000US37179,37179,"Union County, North Carolina",Union County, North Carolina,26703,4075,1754,2321,7265,442,188,254,67,9,0,9,26296,3711,1701,2010,7760,530,210,320,568,105,63,42,5509,814,447,367
1983,17176,2068,974,1094,0500000US37181,37181,"Vance County, North Carolina",Vance County, North Carolina,21699,5460,2438,3022,1594,138,85,53,0,0,0,0,3538,1111,396,715,375,0,0,0,499,409,159,250,1494,271,78,193
1984,632887,33906,15306,18600,0500000US37183,37183,"Wake County, North Carolina",Wake County, North Carolina,214718,28820,12724,16096,46691,5730,2588,3142,461,151,23,128,109732,17637,7199,10438,79174,5636,2965,2671,3253,316,179,137,42712,8973,3398,5575
1985,7193,944,375,569,0500000US37185,37185,"Warren County, North Carolina",Warren County, North Carolina,9407,2510,900,1610,517,110,19,91,31,0,0,0,719,146,70,76,94,24,0,24,1101,229,87,142,327,44,26,18
1986,5113,680,216,464,0500000US37187,37187,"Washington County, North Carolina",Washington County, North Carolina,5669,2323,1216,1107,234,0,0,0,0,0,0,0,635,172,46,126,35,0,0,0,50,0,0,0,320,154,46,108
1987,46025,10665,5483,5182,0500000US37189,37189,"Watauga County, North Carolina",Watauga County, North Carolina,609,280,200,80,833,316,135,181,52,21,0,21,1719,722,371,351,549,256,111,145,271,18,13,5,646,342,137,205
1988,63989,7148,3285,3863,0500000US37191,37191,"Wayne County, North Carolina",Wayne County, North Carolina,36716,9397,3547,5850,5606,1193,620,573,17,0,0,0,14639,4847,2004,2843,1343,74,35,39,299,6,2,4,1709,381,106,275
1989,58726,8667,3462,5205,0500000US37193,37193,"Wilkes County, North Carolina",Wilkes County, North Carolina,2485,526,261,265,1959,647,239,408,219,24,24,0,4366,1397,658,739,406,0,0,0,130,41,0,41,1154,380,130,250
1990,37258,3211,1436,1775,0500000US37195,37195,"Wilson County, North Carolina",Wilson County, North Carolina,31816,8264,3918,4346,2534,1145,657,488,0,0,0,0,8514,3336,1400,1936,516,39,39,0,372,289,153,136,4914,2222,976,1246
1991,31315,3701,1551,2150,0500000US37197,37197,"Yadkin County, North Carolina",Yadkin County, North Carolina,1175,209,46,163,1185,583,365,218,22,0,0,0,4138,1284,753,531,38,0,0,0,120,11,0,11,630,87,44,43
1992,16408,2107,1019,1088,0500000US37199,37199,"Yancey County, North Carolina",Yancey County, North Carolina,73,3,3,0,427,220,171,49,4,0,0,0,928,348,207,141,53,24,0,24,93,22,12,10,169,1,0,1
1993,2065,288,159,129,0500000US38001,38001,"Adams County, North Dakota",Adams County, North Dakota,36,0,0,0,12,1,1,0,0,0,0,0,38,0,0,0,52,0,0,0,3,0,0,0,0,0,0,0
1994,9051,834,375,459,0500000US38003,38003,"Barnes County, North Dakota",Barnes County, North Dakota,222,136,0,136,376,7,0,7,5,0,0,0,208,13,13,0,80,0,0,0,195,1,1,0,9,4,4,0
1995,2775,323,108,215,0500000US38005,38005,"Benson County, North Dakota",Benson County, North Dakota,13,11,0,11,308,48,35,13,5,0,0,0,250,53,9,44,4,0,0,0,3656,1818,911,907,32,0,0,0
1996,886,97,68,29,0500000US38007,38007,"Billings County, North Dakota",Billings County, North Dakota,0,0,0,0,0,0,0,0,0,0,0,0,0,0,0,0,0,0,0,0,0,0,0,0,0,0,0,0
1997,5598,414,216,198,0500000US38009,38009,"Bottineau County, North Dakota",Bottineau County, North Dakota,5,0,0,0,102,6,0,6,0,0,0,0,107,11,10,1,17,0,0,0,250,115,62,53,32,0,0,0
1998,2815,203,99,104,0500000US38011,38011,"Bowman County, North Dakota",Bowman County, North Dakota,0,0,0,0,29,5,2,3,4,4,0,4,166,17,0,17,0,0,0,0,26,1,0,1,30,0,0,0
1999,1983,132,64,68,0500000US38013,38013,"Burke County, North Dakota",Burke County, North Dakota,16,0,0,0,61,11,11,0,0,0,0,0,15,0,0,0,33,0,0,0,23,0,0,0,8,0,0,0
2000,81130,4574,1721,2853,0500000US38015,38015,"Burleigh County, North Dakota",Burleigh County, North Dakota,2117,470,263,207,3010,376,49,327,79,0,0,0,2322,486,177,309,731,43,20,23,3598,1144,627,517,362,99,25,74
2001,148169,11533,5650,5883,0500000US38017,38017,"Cass County, North Dakota",Cass County, North Dakota,10706,3989,1657,2332,5550,810,448,362,51,0,0,0,4911,635,254,381,5783,1349,919,430,1534,467,189,278,952,134,20,114
2002,3436,407,201,206,0500000US38019,38019,"Cavalier County, North Dakota",Cavalier County, North Dakota,0,0,0,0,48,16,12,4,0,0,0,0,89,0,0,0,0,0,0,0,50,0,0,0,127,38,24,14
2003,4307,228,133,95,0500000US38021,38021,"Dickey County, North Dakota",Dickey County, North Dakota,33,0,0,0,67,29,29,0,0,0,0,0,163,29,29,0,0,0,0,0,81,0,0,0,23,0,0,0
2004,1987,150,81,69,0500000US38023,38023,"Divide County, North Dakota",Divide County, North Dakota,57,0,0,0,54,12,3,9,0,0,0,0,111,1,1,0,0,0,0,0,25,1,1,0,0,0,0,0
2005,3530,175,78,97,0500000US38025,38025,"Dunn County, North Dakota",Dunn County, North Dakota,72,0,0,0,111,2,2,0,14,0,0,0,166,28,22,6,51,9,0,9,377,75,36,39,55,15,15,0
2006,1911,155,60,95,0500000US38027,38027,"Eddy County, North Dakota",Eddy County, North Dakota,0,0,0,0,110,21,1,20,2,2,0,2,46,3,3,0,0,0,0,0,120,53,14,39,23,3,3,0
2007,3114,258,145,113,0500000US38029,38029,"Emmons County, North Dakota",Emmons County, North Dakota,0,0,0,0,28,0,0,0,0,0,0,0,26,0,0,0,36,13,6,7,11,0,0,0,6,5,5,0
2008,2979,215,82,133,0500000US38031,38031,"Foster County, North Dakota",Foster County, North Dakota,18,0,0,0,68,1,0,1,14,0,0,0,17,4,0,4,2,2,2,0,44,29,8,21,0,0,0,0
2009,1539,87,26,61,0500000US38033,38033,"Golden Valley County, North Dakota",Golden Valley County, North Dakota,0,0,0,0,112,0,0,0,0,0,0,0,65,0,0,0,0,0,0,0,29,0,0,0,0,0,0,0
2010,54894,7458,4027,3431,0500000US38035,38035,"Grand Forks County, North Dakota",Grand Forks County, North Dakota,2562,513,272,241,2101,312,167,145,411,360,258,102,2786,567,235,332,1874,397,216,181,1782,711,326,385,1044,111,60,51
2011,2154,227,127,100,0500000US38037,38037,"Grant County, North Dakota",Grant County, North Dakota,0,0,0,0,41,4,1,3,1,0,0,0,14,6,4,2,37,0,0,0,27,1,0,1,0,0,0,0
2012,2148,96,31,65,0500000US38039,38039,"Griggs County, North Dakota",Griggs County, North Dakota,0,0,0,0,60,0,0,0,0,0,0,0,36,0,0,0,0,0,0,0,11,0,0,0,0,0,0,0
2013,2169,193,79,114,0500000US38041,38041,"Hettinger County, North Dakota",Hettinger County, North Dakota,0,0,0,0,88,0,0,0,1,0,0,0,69,0,0,0,0,0,0,0,11,7,7,0,44,0,0,0
2014,2272,202,113,89,0500000US38043,38043,"Kidder County, North Dakota",Kidder County, North Dakota,14,0,0,0,17,4,4,0,0,0,0,0,119,35,35,0,6,0,0,0,3,0,0,0,36,15,15,0
2015,3947,550,251,299,0500000US38045,38045,"LaMoure County, North Dakota",LaMoure County, North Dakota,29,0,0,0,104,0,0,0,0,0,0,0,89,0,0,0,4,4,0,4,12,2,0,2,17,0,0,0
2016,1615,115,60,55,0500000US38047,38047,"Logan County, North Dakota",Logan County, North Dakota,0,0,0,0,33,4,1,3,0,0,0,0,18,0,0,0,1,0,0,0,2,0,0,0,12,0,0,0
2017,5467,467,254,213,0500000US38049,38049,"McHenry County, North Dakota",McHenry County, North Dakota,27,24,1,23,52,1,0,1,0,0,0,0,122,16,8,8,20,16,1,15,55,9,3,6,7,0,0,0
2018,2290,196,84,112,0500000US38051,38051,"McIntosh County, North Dakota",McIntosh County, North Dakota,10,0,0,0,14,0,0,0,0,0,0,0,73,51,41,10,16,0,0,0,16,0,0,0,53,51,41,10
2019,10489,533,315,218,0500000US38053,38053,"McKenzie County, North Dakota",McKenzie County, North Dakota,212,12,4,8,482,74,1,73,0,0,0,0,1257,478,372,106,90,0,0,0,1360,419,196,223,266,71,43,28
2020,8355,598,253,345,0500000US38055,38055,"McLean County, North Dakota",McLean County, North Dakota,41,0,0,0,235,10,6,4,21,2,0,2,243,33,29,4,12,1,0,1,609,82,25,57,63,0,0,0
2021,7458,473,193,280,0500000US38057,38057,"Mercer County, North Dakota",Mercer County, North Dakota,56,32,0,32,21,0,0,0,0,0,0,0,228,35,14,21,26,0,0,0,265,64,14,50,247,104,47,57
2022,27308,1601,495,1106,0500000US38059,38059,"Morton County, North Dakota",Morton County, North Dakota,359,0,0,0,547,44,19,25,43,43,0,43,1158,283,236,47,213,195,111,84,1042,170,108,62,479,60,60,0
2023,6152,401,211,190,0500000US38061,38061,"Mountrail County, North Dakota",Mountrail County, North Dakota,151,0,0,0,273,40,3,37,21,0,0,0,855,81,66,15,54,0,0,0,2990,640,339,301,261,0,0,0
2024,2563,244,116,128,0500000US38063,38063,"Nelson County, North Dakota",Nelson County, North Dakota,3,0,0,0,100,31,1,30,0,0,0,0,108,16,8,8,16,0,0,0,0,0,0,0,85,15,8,7
2025,1790,178,102,76,0500000US38065,38065,"Oliver County, North Dakota",Oliver County, North Dakota,0,0,0,0,127,50,23,27,12,0,0,0,73,0,0,0,5,0,0,0,28,0,0,0,0,0,0,0
2026,6056,391,211,180,0500000US38067,38067,"Pembina County, North Dakota",Pembina County, North Dakota,19,0,0,0,155,3,1,2,0,0,0,0,234,10,10,0,44,0,0,0,141,74,51,23,2,0,0,0
2027,3663,441,182,259,0500000US38069,38069,"Pierce County, North Dakota",Pierce County, North Dakota,7,0,0,0,50,3,3,0,0,0,0,0,29,19,0,19,45,0,0,0,104,27,11,16,0,0,0,0
2028,9194,1376,787,589,0500000US38071,38071,"Ramsey County, North Dakota",Ramsey County, North Dakota,39,37,37,0,497,176,90,86,0,0,0,0,284,89,54,35,168,0,0,0,1056,287,90,197,35,1,0,1
2029,4775,484,213,271,0500000US38073,38073,"Ransom County, North Dakota",Ransom County, North Dakota,12,0,0,0,48,3,0,3,0,0,0,0,79,0,0,0,157,0,0,0,23,0,0,0,67,0,0,0
2030,2131,74,41,33,0500000US38075,38075,"Renville County, North Dakota",Renville County, North Dakota,7,0,0,0,60,2,0,2,0,0,0,0,133,17,0,17,6,0,0,0,1,0,0,0,15,15,0,15
2031,13735,1416,591,825,0500000US38077,38077,"Richland County, North Dakota",Richland County, North Dakota,45,45,9,36,534,86,70,16,0,0,0,0,494,171,120,51,67,0,0,0,260,130,64,66,234,12,12,0
2032,2531,150,64,86,0500000US38079,38079,"Rolette County, North Dakota",Rolette County, North Dakota,84,73,38,35,530,163,96,67,0,0,0,0,328,214,99,115,12,0,0,0,10865,3315,1580,1735,79,43,43,0
2033,3509,152,60,92,0500000US38081,38081,"Sargent County, North Dakota",Sargent County, North Dakota,121,0,0,0,91,1,0,1,0,0,0,0,124,12,10,2,4,0,0,0,19,0,0,0,18,7,7,0
2034,1240,79,32,47,0500000US38083,38083,"Sheridan County, North Dakota",Sheridan County, North Dakota,0,0,0,0,0,0,0,0,0,0,0,0,0,0,0,0,0,0,0,0,26,0,0,0,0,0,0,0
2035,491,39,20,19,0500000US38085,38085,"Sioux County, North Dakota",Sioux County, North Dakota,3,3,0,3,93,54,0,54,0,0,0,0,197,30,0,30,0,0,0,0,3570,1308,646,662,78,0,0,0
2036,753,34,14,20,0500000US38087,38087,"Slope County, North Dakota",Slope County, North Dakota,19,0,0,0,9,5,4,1,0,0,0,0,1,1,0,1,0,0,0,0,7,0,0,0,0,0,0,0
2037,26561,2040,795,1245,0500000US38089,38089,"Stark County, North Dakota",Stark County, North Dakota,792,122,122,0,648,152,96,56,81,0,0,0,1681,601,428,173,382,179,12,167,517,217,81,136,635,359,291,68
2038,1742,174,73,101,0500000US38091,38091,"Steele County, North Dakota",Steele County, North Dakota,9,0,0,0,52,0,0,0,0,0,0,0,48,0,0,0,0,0,0,0,0,0,0,0,10,0,0,0
2039,17927,2120,1013,1107,0500000US38093,38093,"Stutsman County, North Dakota",Stutsman County, North Dakota,237,53,8,45,547,138,77,61,0,0,0,0,486,123,69,54,80,0,0,0,238,57,45,12,84,3,0,3
2040,1866,165,60,105,0500000US38095,38095,"Towner County, North Dakota",Towner County, North Dakota,10,0,0,0,18,0,0,0,0,0,0,0,79,4,4,0,4,4,3,1,162,21,10,11,0,0,0,0
2041,6992,333,142,191,0500000US38097,38097,"Traill County, North Dakota",Traill County, North Dakota,52,9,9,0,206,4,0,4,0,0,0,0,268,7,0,7,25,0,0,0,85,0,0,0,144,0,0,0
2042,8752,801,368,433,0500000US38099,38099,"Walsh County, North Dakota",Walsh County, North Dakota,31,6,0,6,309,24,7,17,0,0,0,0,1232,113,47,66,83,0,0,0,250,93,0,93,76,0,0,0
2043,55048,4278,1685,2593,0500000US38101,38101,"Ward County, North Dakota",Ward County, North Dakota,3105,198,114,84,2947,321,98,223,186,35,35,0,4112,873,524,349,972,22,0,22,1246,422,53,369,1017,335,190,145
2044,3706,258,118,140,0500000US38103,38103,"Wells County, North Dakota",Wells County, North Dakota,0,0,0,0,11,0,0,0,0,0,0,0,92,66,6,60,6,0,0,0,2,2,0,2,22,4,4,0
2045,27710,1284,541,743,0500000US38105,38105,"Williams County, North Dakota",Williams County, North Dakota,1595,458,132,326,1968,191,71,120,47,47,0,47,3053,131,67,64,436,8,4,4,934,39,9,30,1617,5,0,5
2046,26247,5266,2217,3049,0500000US39001,39001,"Adams County, Ohio",Adams County, Ohio,129,27,21,6,550,221,196,25,0,0,0,0,283,6,1,5,97,0,0,0,7,0,0,0,21,0,0,0
2047,79363,7350,3185,4165,0500000US39003,39003,"Allen County, Ohio",Allen County, Ohio,10620,3771,1441,2330,4674,1113,724,389,0,0,0,0,3280,399,255,144,856,91,56,35,161,30,3,27,1057,222,139,83
2048,48876,6053,2988,3065,0500000US39005,39005,"Ashland County, Ohio",Ashland County, Ohio,340,43,20,23,957,152,40,112,0,0,0,0,721,156,64,92,292,31,0,31,0,0,0,0,114,35,35,0
2049,84758,15273,6944,8329,0500000US39007,39007,"Ashtabula County, Ohio",Ashtabula County, Ohio,2805,831,529,302,2651,793,445,348,8,5,0,5,4091,1395,682,713,453,31,13,18,98,24,13,11,372,36,36,0
2050,51214,13481,6991,6490,0500000US39009,39009,"Athens County, Ohio",Athens County, Ohio,1132,355,84,271,1660,929,331,598,12,7,0,7,914,361,203,158,1407,547,305,242,142,93,0,93,199,31,23,8
2051,42897,2964,946,2018,0500000US39011,39011,"Auglaize County, Ohio",Auglaize County, Ohio,309,80,49,31,846,289,189,100,2,2,0,2,791,222,126,96,127,2,2,0,30,4,4,0,426,79,18,61
2052,59521,6441,2934,3507,0500000US39013,39013,"Belmont County, Ohio",Belmont County, Ohio,1277,316,246,70,1383,546,391,155,14,0,0,0,582,50,2,48,378,24,0,24,89,52,0,52,227,42,0,42
2053,41185,6960,2975,3985,0500000US39015,39015,"Brown County, Ohio",Brown County, Ohio,312,101,21,80,681,115,44,71,0,0,0,0,476,0,0,0,93,0,0,0,22,20,0,20,106,0,0,0
2054,295737,28122,12201,15921,0500000US39017,39017,"Butler County, Ohio",Butler County, Ohio,28175,5064,1986,3078,16894,3515,1386,2129,64,20,0,20,17655,4099,1842,2257,12587,2256,1047,1209,406,153,84,69,4456,852,363,489
2055,25647,3374,1447,1927,0500000US39019,39019,"Carroll County, Ohio",Carroll County, Ohio,262,49,23,26,529,30,7,23,0,0,0,0,356,32,24,8,25,0,0,0,0,0,0,0,0,0,0,0
2056,35383,3625,1538,2087,0500000US39021,39021,"Champaign County, Ohio",Champaign County, Ohio,506,104,77,27,1181,118,59,59,6,0,0,0,596,97,22,75,142,6,0,6,84,48,0,48,139,27,27,0
2057,109932,14398,6050,8348,0500000US39023,39023,"Clark County, Ohio",Clark County, Ohio,10613,2470,1226,1244,5077,1323,591,732,16,0,0,0,4625,1670,809,861,642,60,0,60,199,102,44,58,1168,671,481,190
2058,189429,16577,6972,9605,0500000US39025,39025,"Clermont County, Ohio",Clermont County, Ohio,2410,370,260,110,4807,1014,469,545,83,0,0,0,4105,723,334,389,2861,321,89,232,179,36,30,6,578,15,5,10
2059,37853,4844,2108,2736,0500000US39027,39027,"Clinton County, Ohio",Clinton County, Ohio,701,311,57,254,1130,389,184,205,8,0,0,0,698,245,88,157,260,43,27,16,23,0,0,0,299,198,67,131
2060,93212,11951,5174,6777,0500000US39029,39029,"Columbiana County, Ohio",Columbiana County, Ohio,1242,419,235,184,2236,825,390,435,9,0,0,0,1636,375,250,125,281,0,0,0,56,34,0,34,886,334,228,106
2061,34493,5868,2876,2992,0500000US39031,39031,"Coshocton County, Ohio",Coshocton County, Ohio,422,110,89,21,504,122,50,72,0,0,0,0,400,42,7,35,108,86,44,42,58,17,17,0,51,0,0,0
2062,38659,5189,2181,3008,0500000US39033,39033,"Crawford County, Ohio",Crawford County, Ohio,459,128,88,40,566,168,87,81,25,0,0,0,691,18,0,18,273,0,0,0,62,21,4,17,63,0,0,0
2063,708484,65926,28999,36927,0500000US39035,39035,"Cuyahoga County, Ohio",Cuyahoga County, Ohio,356794,109162,48021,61141,48946,10892,4800,6092,441,215,142,73,75222,19199,8841,10358,37112,5066,2365,2701,2760,801,406,395,23370,6740,3323,3417
2064,48529,5124,2210,2914,0500000US39037,39037,"Darke County, Ohio",Darke County, Ohio,338,28,16,12,632,144,77,67,0,0,0,0,810,186,73,113,183,75,49,26,125,9,3,6,103,0,0,0
2065,32168,2816,1116,1700,0500000US39039,39039,"Defiance County, Ohio",Defiance County, Ohio,522,160,150,10,1434,322,149,173,18,0,0,0,3824,607,288,319,148,19,12,7,153,0,0,0,1283,96,29,67
2066,170429,7354,3149,4205,0500000US39041,39041,"Delaware County, Ohio",Delaware County, Ohio,6754,528,248,280,6379,1024,543,481,34,0,0,0,5453,638,433,205,13889,353,113,240,230,7,7,0,1228,81,71,10
2067,60435,5685,2364,3321,0500000US39043,39043,"Erie County, Ohio",Erie County, Ohio,6567,1861,653,1208,2777,662,401,261,7,0,0,0,3340,624,281,343,578,5,4,1,294,76,25,51,881,167,94,73
2068,130646,11356,4792,6564,0500000US39045,39045,"Fairfield County, Ohio",Fairfield County, Ohio,11119,1085,674,411,5731,489,288,201,49,0,0,0,3569,728,399,329,2624,64,15,49,105,27,10,17,1275,504,317,187
2069,26000,3629,1364,2265,0500000US39047,39047,"Fayette County, Ohio",Fayette County, Ohio,623,91,36,55,695,367,202,165,11,6,0,6,618,295,180,115,291,75,21,54,8,0,0,0,276,195,116,79
2070,790463,78521,36311,42210,0500000US39049,39049,"Franklin County, Ohio",Franklin County, Ohio,291377,76700,35069,41631,59563,12011,5794,6217,440,38,38,0,72486,18552,9115,9437,68395,9370,3796,5574,2519,169,116,53,24721,7017,3452,3565
2071,36816,2753,1100,1653,0500000US39051,39051,"Fulton County, Ohio",Fulton County, Ohio,102,14,14,0,1511,420,148,272,20,20,20,0,3713,670,284,386,228,44,0,44,176,20,16,4,907,193,88,105
2072,27217,4395,2220,2175,0500000US39053,39053,"Gallia County, Ohio",Gallia County, Ohio,438,92,75,17,771,420,219,201,47,47,47,0,375,190,118,72,230,0,0,0,150,81,21,60,194,0,0,0
2073,88131,4691,2181,2510,0500000US39055,39055,"Geauga County, Ohio",Geauga County, Ohio,1118,212,105,107,1631,200,38,162,0,0,0,0,1452,161,91,70,516,13,13,0,99,0,0,0,339,221,221,0
2074,133304,13318,5622,7696,0500000US39057,39057,"Greene County, Ohio",Greene County, Ohio,8556,1614,797,817,7306,1463,791,672,77,0,0,0,4740,626,240,386,4933,436,283,153,163,57,0,57,1590,195,50,145
2075,36259,6675,3016,3659,0500000US39059,39059,"Guernsey County, Ohio",Guernsey County, Ohio,654,197,139,58,803,274,108,166,0,0,0,0,429,83,45,38,160,33,33,0,82,12,6,6,228,118,48,70
2076,514516,46132,20688,25444,0500000US39061,39061,"Hamilton County, Ohio",Hamilton County, Ohio,204813,56009,24063,31946,30265,6035,2586,3449,551,356,252,104,27551,7638,3714,3924,21788,2517,1453,1064,896,68,59,9,9635,2664,1159,1505
2077,65253,6333,2290,4043,0500000US39063,39063,"Hancock County, Ohio",Hancock County, Ohio,888,176,45,131,1719,280,161,119,0,0,0,0,4189,568,248,320,1551,219,166,53,76,64,22,42,1310,72,15,57
2078,27561,3905,1584,2321,0500000US39065,39065,"Hardin County, Ohio",Hardin County, Ohio,156,39,29,10,472,98,27,71,0,0,0,0,400,60,25,35,140,13,0,13,1,0,0,0,214,26,26,0
2079,14044,2167,1042,1125,0500000US39067,39067,"Harrison County, Ohio",Harrison County, Ohio,418,200,75,125,172,16,3,13,0,0,0,0,56,0,0,0,78,34,34,0,0,0,0,0,30,0,0,0
2080,23839,1741,827,914,0500000US39069,39069,"Henry County, Ohio",Henry County, Ohio,175,16,9,7,667,145,75,70,22,17,14,3,2094,361,144,217,89,0,0,0,84,0,0,0,817,196,70,126
2081,40336,7380,3298,4082,0500000US39071,39071,"Highland County, Ohio",Highland County, Ohio,654,201,44,157,811,299,214,85,0,0,0,0,513,80,41,39,139,40,16,24,97,58,10,48,106,32,32,0
2082,26765,3636,1518,2118,0500000US39073,39073,"Hocking County, Ohio",Hocking County, Ohio,124,34,19,15,635,247,90,157,0,0,0,0,273,104,104,0,22,6,3,3,10,0,0,0,115,104,104,0
2083,42210,4101,1884,2217,0500000US39075,39075,"Holmes County, Ohio",Holmes County, Ohio,8,5,5,0,388,69,11,58,0,0,0,0,424,2,2,0,134,6,0,6,115,21,21,0,33,0,0,0
2084,51721,5585,2418,3167,0500000US39077,39077,"Huron County, Ohio",Huron County, Ohio,946,244,162,82,1272,256,99,157,8,0,0,0,3871,709,452,257,123,37,0,37,216,56,28,28,353,83,42,41
2085,30440,5095,1980,3115,0500000US39079,39079,"Jackson County, Ohio",Jackson County, Ohio,299,76,33,43,700,134,64,70,55,55,55,0,360,84,32,52,0,0,0,0,18,0,0,0,16,0,0,0
2086,57415,8765,3973,4792,0500000US39081,39081,"Jefferson County, Ohio",Jefferson County, Ohio,3718,1204,664,540,1458,373,233,140,0,0,0,0,919,341,163,178,380,68,38,30,18,0,0,0,247,146,61,85
2087,55173,6289,2698,3591,0500000US39083,39083,"Knox County, Ohio",Knox County, Ohio,406,80,41,39,1191,342,103,239,8,8,0,8,807,80,36,44,249,24,19,5,162,84,42,42,422,142,98,44
2088,198483,13768,5962,7806,0500000US39085,39085,"Lake County, Ohio",Lake County, Ohio,9569,1608,600,1008,6128,1130,603,527,61,0,0,0,10260,2160,934,1226,2877,272,150,122,181,12,8,4,3331,808,358,450
2089,55786,10846,4715,6131,0500000US39087,39087,"Lawrence County, Ohio",Lawrence County, Ohio,973,155,97,58,1328,349,112,237,12,0,0,0,587,77,0,77,224,37,0,37,7,0,0,0,273,43,0,43
2090,153155,14643,6682,7961,0500000US39089,39089,"Licking County, Ohio",Licking County, Ohio,7193,800,326,474,5116,973,338,635,25,25,25,0,3304,291,124,167,2543,13,6,7,211,36,19,17,584,16,2,14
2091,41607,4280,1742,2538,0500000US39091,39091,"Logan County, Ohio",Logan County, Ohio,637,78,43,35,1422,213,111,102,36,11,11,0,780,75,49,26,343,118,29,89,42,0,0,0,188,1,1,0
2092,234622,21308,8439,12869,0500000US39093,39093,"Lorain County, Ohio",Lorain County, Ohio,22975,8166,4070,4096,15179,3819,1783,2036,89,10,10,0,30679,8558,3582,4976,3314,482,233,249,931,119,40,79,3606,1050,460,590
2093,285948,35493,15356,20137,0500000US39095,39095,"Lucas County, Ohio",Lucas County, Ohio,79401,27289,11672,15617,22449,7998,4324,3674,128,15,0,15,31108,8546,3886,4660,7193,1425,656,769,1324,391,275,116,10191,3136,1521,1615
2094,36320,3002,1148,1854,0500000US39097,39097,"Madison County, Ohio",Madison County, Ohio,418,128,47,81,1170,326,162,164,4,0,0,0,778,202,62,140,278,0,0,0,13,4,0,4,151,2,2,0
2095,167276,19607,8726,10881,0500000US39099,39099,"Mahoning County, Ohio",Mahoning County, Ohio,32015,12049,5023,7026,9448,3265,1653,1612,40,31,8,23,14071,5193,2989,2204,2123,181,69,112,511,79,27,52,3021,1387,866,521
2096,54313,6576,2871,3705,0500000US39101,39101,"Marion County, Ohio",Marion County, Ohio,1407,388,205,183,2171,701,419,282,0,0,0,0,1348,625,256,369,450,86,0,86,65,40,20,20,359,23,8,15
2097,165323,8815,3324,5491,0500000US39103,39103,"Medina County, Ohio",Medina County, Ohio,2256,225,127,98,4063,466,266,200,0,0,0,0,4061,787,394,393,1807,108,77,31,306,26,15,11,1094,38,30,8
2098,21826,4342,2034,2308,0500000US39105,39105,"Meigs County, Ohio",Meigs County, Ohio,99,23,7,16,506,201,137,64,0,0,0,0,181,5,0,5,0,0,0,0,22,22,0,22,48,5,0,5
2099,38390,2055,874,1181,0500000US39107,39107,"Mercer County, Ohio",Mercer County, Ohio,223,47,39,8,392,57,24,33,337,20,20,0,763,89,81,8,254,2,0,2,0,0,0,0,110,4,4,0
2100,96547,7442,3212,4230,0500000US39109,39109,"Miami County, Ohio",Miami County, Ohio,1835,384,174,210,3119,730,301,429,7,7,7,0,1855,279,126,153,1434,25,4,21,140,30,0,30,341,23,0,23
2101,13291,1948,1023,925,0500000US39111,39111,"Monroe County, Ohio",Monroe County, Ohio,50,1,1,0,276,47,9,38,0,0,0,0,15,9,4,5,67,0,0,0,0,0,0,0,1,1,0,1
2102,358451,40642,17932,22710,0500000US39113,39113,"Montgomery County, Ohio",Montgomery County, Ohio,107346,32210,14837,17373,20887,4469,2087,2382,208,37,4,33,16119,3600,1760,1840,11601,1658,1031,627,962,341,133,208,5360,1287,738,549
2103,13148,2181,968,1213,0500000US39115,39115,"Morgan County, Ohio",Morgan County, Ohio,519,69,21,48,464,158,86,72,0,0,0,0,139,67,10,57,12,0,0,0,24,5,5,0,65,0,0,0
2104,33372,3008,1413,1595,0500000US39117,39117,"Morrow County, Ohio",Morrow County, Ohio,249,65,36,29,867,100,6,94,0,0,0,0,529,0,0,0,155,0,0,0,46,0,0,0,61,0,0,0
2105,76416,10554,4629,5925,0500000US39119,39119,"Muskingum County, Ohio",Muskingum County, Ohio,2467,910,521,389,3601,1404,685,719,57,0,0,0,902,123,59,64,431,75,26,49,128,37,13,24,430,40,0,40
2106,11803,1819,711,1108,0500000US39121,39121,"Noble County, Ohio",Noble County, Ohio,74,1,1,0,110,5,5,0,0,0,0,0,37,1,1,0,0,0,0,0,26,0,0,0,37,1,1,0
2107,36682,3050,1049,2001,0500000US39123,39123,"Ottawa County, Ohio",Ottawa County, Ohio,493,133,106,27,872,113,95,18,2,0,0,0,2086,271,116,155,99,0,0,0,139,9,9,0,463,19,13,6
2108,17069,1705,680,1025,0500000US39125,39125,"Paulding County, Ohio",Paulding County, Ohio,104,0,0,0,589,175,104,71,10,0,0,0,903,71,38,33,44,0,0,0,22,5,5,0,124,11,0,11
2109,34277,5501,2625,2876,0500000US39127,39127,"Perry County, Ohio",Perry County, Ohio,259,46,20,26,610,222,69,153,22,0,0,0,305,14,10,4,32,0,0,0,80,63,5,58,105,16,16,0
2110,51092,7065,3385,3680,0500000US39129,39129,"Pickaway County, Ohio",Pickaway County, Ohio,545,56,37,19,933,45,38,7,0,0,0,0,614,62,1,61,289,157,69,88,145,0,0,0,262,61,0,61
2111,26145,4900,2082,2818,0500000US39131,39131,"Pike County, Ohio",Pike County, Ohio,206,32,14,18,596,82,79,3,88,0,0,0,229,8,0,8,27,0,0,0,172,92,0,92,49,0,0,0
2112,138200,13414,6128,7286,0500000US39133,39133,"Portage County, Ohio",Portage County, Ohio,6197,1671,593,1078,5352,1276,517,759,50,25,0,25,2777,470,274,196,2814,627,235,392,145,103,51,52,621,29,0,29
2113,38827,3557,1465,2092,0500000US39135,39135,"Preble County, Ohio",Preble County, Ohio,270,29,13,16,846,85,46,39,3,3,0,3,376,17,17,0,109,6,6,0,48,0,0,0,55,0,0,0
2114,30806,2138,762,1376,0500000US39137,39137,"Putnam County, Ohio",Putnam County, Ohio,208,78,43,35,457,65,34,31,0,0,0,0,2078,415,236,179,43,3,0,3,9,7,4,3,1138,246,146,100
2115,99126,11582,5167,6415,0500000US39139,39139,"Richland County, Ohio",Richland County, Ohio,7645,2242,1013,1229,3842,1085,749,336,87,4,0,4,1983,522,167,355,838,55,10,45,116,28,20,8,539,132,61,71
2116,64990,10370,4564,5806,0500000US39141,39141,"Ross County, Ohio",Ross County, Ohio,2373,293,179,114,2190,616,179,437,15,0,0,0,833,107,27,80,390,163,0,163,1,0,0,0,296,13,0,13
2117,48145,5191,2344,2847,0500000US39143,39143,"Sandusky County, Ohio",Sandusky County, Ohio,1525,438,285,153,2541,785,571,214,12,0,0,0,5789,759,170,589,287,22,8,14,106,19,14,5,1255,142,24,118
2118,67964,15417,6902,8515,0500000US39145,39145,"Scioto County, Ohio",Scioto County, Ohio,1214,466,190,276,1454,372,149,223,0,0,0,0,903,294,176,118,330,72,21,51,158,0,0,0,148,24,12,12
2119,46867,5312,2212,3100,0500000US39147,39147,"Seneca County, Ohio",Seneca County, Ohio,1200,489,226,263,1131,292,133,159,0,0,0,0,2697,522,206,316,333,81,69,12,198,23,3,20,544,72,50,22
2120,44255,4309,1944,2365,0500000US39149,39149,"Shelby County, Ohio",Shelby County, Ohio,1133,271,161,110,1131,48,7,41,0,0,0,0,739,109,84,25,431,51,13,38,99,0,0,0,200,4,0,4
2121,311621,32504,13780,18724,0500000US39151,39151,"Stark County, Ohio",Stark County, Ohio,26444,9074,4510,4564,13778,4858,2204,2654,12,0,0,0,7607,2132,1082,1050,3256,144,64,80,440,68,15,53,2487,816,363,453
2122,405478,37996,15988,22008,0500000US39153,39153,"Summit County, Ohio",Summit County, Ohio,75427,20725,8894,11831,19260,4139,1886,2253,59,4,0,4,11816,2049,938,1111,19826,3508,1675,1833,909,176,80,96,2572,426,255,171
2123,169899,24498,10393,14105,0500000US39155,39155,"Trumbull County, Ohio",Trumbull County, Ohio,15110,5749,2064,3685,5939,2587,1197,1390,175,0,0,0,3657,1387,628,759,1053,164,37,127,222,70,50,20,389,48,31,17
2124,85465,9910,4245,5665,0500000US39157,39157,"Tuscarawas County, Ohio",Tuscarawas County, Ohio,517,154,137,17,1870,557,229,328,0,0,0,0,2770,1099,731,368,360,57,19,38,77,51,0,51,325,131,104,27
2125,48879,2611,1164,1447,0500000US39159,39159,"Union County, Ohio",Union County, Ohio,849,56,5,51,1330,111,15,96,37,0,0,0,977,9,9,0,2419,1,0,1,129,19,0,19,124,14,14,0
2126,26028,2382,949,1433,0500000US39161,39161,"Van Wert County, Ohio",Van Wert County, Ohio,243,22,12,10,590,16,15,1,0,0,0,0,1002,184,91,93,78,9,0,9,92,74,23,51,134,2,2,0
2127,12499,2543,1221,1322,0500000US39163,39163,"Vinton County, Ohio",Vinton County, Ohio,3,3,0,3,236,46,20,26,0,0,0,0,174,0,0,0,31,1,0,1,11,1,0,1,0,0,0,0
2128,194497,9045,3764,5281,0500000US39165,39165,"Warren County, Ohio",Warren County, Ohio,5213,155,91,64,5363,475,90,385,5,0,0,0,6589,418,121,297,14192,801,540,261,199,35,35,0,1007,10,10,0
2129,55574,7091,2883,4208,0500000US39167,39167,"Washington County, Ohio",Washington County, Ohio,704,220,146,74,967,154,105,49,0,0,0,0,633,111,61,50,298,19,0,19,246,94,49,45,121,51,7,44
2130,105111,10674,4273,6401,0500000US39169,39169,"Wayne County, Ohio",Wayne County, Ohio,1200,235,95,140,2235,217,75,142,11,0,0,0,2300,675,359,316,1003,96,64,32,147,39,16,23,1340,582,372,210
2131,33052,3616,1549,2067,0500000US39171,39171,"Williams County, Ohio",Williams County, Ohio,217,52,31,21,885,128,57,71,16,0,0,0,1683,186,81,105,215,0,0,0,86,26,14,12,405,5,5,0
2132,109767,12890,5786,7104,0500000US39173,39173,"Wood County, Ohio",Wood County, Ohio,2303,548,177,371,4331,1323,601,722,110,31,0,31,7219,1579,676,903,2088,340,220,120,257,73,48,25,1622,460,249,211
2133,20487,1489,597,892,0500000US39175,39175,"Wyandot County, Ohio",Wyandot County, Ohio,18,5,2,3,437,30,0,30,0,0,0,0,655,24,24,0,214,0,0,0,0,0,0,0,95,19,19,0
2134,8571,1860,844,1016,0500000US40001,40001,"Adair County, Oklahoma",Adair County, Oklahoma,125,93,93,0,2174,505,219,286,22,22,22,0,1528,478,265,213,199,18,17,1,9792,2978,1445,1533,665,293,192,101
2135,4199,474,210,264,0500000US40003,40003,"Alfalfa County, Oklahoma",Alfalfa County, Oklahoma,14,1,0,1,191,18,11,7,0,0,0,0,264,29,21,8,17,1,0,1,49,12,5,7,128,11,11,0
2136,8927,1547,608,939,0500000US40005,40005,"Atoka County, Oklahoma",Atoka County, Oklahoma,189,13,1,12,1768,453,226,227,0,0,0,0,429,58,40,18,53,0,0,0,1307,328,156,172,80,6,6,0
2137,3685,320,146,174,0500000US40007,40007,"Beaver County, Oklahoma",Beaver County, Oklahoma,39,13,13,0,255,17,17,0,0,0,0,0,1291,106,37,69,1,0,0,0,82,0,0,0,754,40,16,24
2138,15147,2284,1006,1278,0500000US40009,40009,"Beckham County, Oklahoma",Beckham County, Oklahoma,277,224,88,136,690,265,142,123,1,1,0,1,2874,1102,665,437,28,0,0,0,467,33,1,32,723,22,18,4
2139,6436,603,303,300,0500000US40011,40011,"Blaine County, Oklahoma",Blaine County, Oklahoma,163,69,1,68,544,23,12,11,0,0,0,0,419,96,19,77,4,0,0,0,656,145,71,74,92,13,0,13
2140,32334,4757,2122,2635,0500000US40013,40013,"Bryan County, Oklahoma",Bryan County, Oklahoma,743,381,242,139,3905,743,365,378,60,0,0,0,2934,581,325,256,298,106,60,46,6337,1449,583,866,1041,224,159,65
2141,16160,1828,773,1055,0500000US40015,40015,"Caddo County, Oklahoma",Caddo County, Oklahoma,628,172,135,37,2659,468,208,260,31,0,0,0,2817,636,228,408,148,0,0,0,6162,2166,942,1224,809,278,94,184
2142,106495,5783,2420,3363,0500000US40017,40017,"Canadian County, Oklahoma",Canadian County, Oklahoma,4029,775,406,369,10604,1072,406,666,22,0,0,0,13433,2645,1256,1389,4347,63,12,51,5632,622,272,350,4240,895,393,502
2143,32871,4996,1908,3088,0500000US40019,40019,"Carter County, Oklahoma",Carter County, Oklahoma,3070,869,378,491,4648,1052,483,569,25,3,0,3,3771,875,441,434,615,15,15,0,3755,521,321,200,645,226,134,92
2144,21751,4070,1715,2355,0500000US40021,40021,"Cherokee County, Oklahoma",Cherokee County, Oklahoma,416,104,57,47,6041,1448,647,801,28,11,6,5,3639,1274,653,621,398,31,12,19,16142,4001,2092,1909,831,265,129,136
2145,8621,1788,768,1020,0500000US40023,40023,"Choctaw County, Oklahoma",Choctaw County, Oklahoma,1555,767,347,420,1370,485,186,299,5,0,0,0,679,305,142,163,19,0,0,0,2404,463,190,273,181,102,25,77
2146,1615,275,96,179,0500000US40025,40025,"Cimarron County, Oklahoma",Cimarron County, Oklahoma,0,0,0,0,36,0,0,0,0,0,0,0,497,58,32,26,0,0,0,0,1,0,0,0,7,1,1,0
2147,192526,21753,9818,11935,0500000US40027,40027,"Cleveland County, Oklahoma",Cleveland County, Oklahoma,12165,2717,1289,1428,22556,3087,1309,1778,182,25,25,0,24352,2715,953,1762,11712,1859,1106,753,11443,1225,449,776,5285,343,180,163
2148,3692,843,387,456,0500000US40029,40029,"Coal County, Oklahoma",Coal County, Oklahoma,6,2,2,0,1045,279,162,117,0,0,0,0,248,70,46,24,36,0,0,0,532,129,43,86,78,6,6,0
2149,62894,7609,3749,3860,0500000US40031,40031,"Comanche County, Oklahoma",Comanche County, Oklahoma,17818,4007,1720,2287,12292,2796,1288,1508,456,131,45,86,14648,2250,1061,1189,2946,570,228,342,5451,1176,515,661,3319,664,326,338
2150,4252,793,420,373,0500000US40033,40033,"Cotton County, Oklahoma",Cotton County, Oklahoma,102,6,5,1,316,75,53,22,0,0,0,0,469,69,26,43,0,0,0,0,582,122,47,75,59,23,8,15
2151,8473,1353,661,692,0500000US40035,40035,"Craig County, Oklahoma",Craig County, Oklahoma,266,86,58,28,1203,350,182,168,25,4,0,4,447,106,39,67,107,38,11,27,2953,513,284,229,135,42,10,32
2152,52915,6573,2748,3825,0500000US40037,40037,"Creek County, Oklahoma",Creek County, Oklahoma,1440,219,152,67,4391,641,230,411,16,4,0,4,3072,752,266,486,420,26,18,8,8260,1688,762,926,658,208,89,119
2153,18423,3179,1440,1739,0500000US40039,40039,"Custer County, Oklahoma",Custer County, Oklahoma,791,29,12,17,2791,401,125,276,0,0,0,0,5225,781,295,486,294,122,17,105,991,171,51,120,1263,170,98,72
2154,26747,3775,1729,2046,0500000US40041,40041,"Delaware County, Oklahoma",Delaware County, Oklahoma,172,26,11,15,4127,856,276,580,39,4,4,0,1641,541,203,338,525,91,29,62,9565,2702,1276,1426,450,92,62,30
2155,3888,297,170,127,0500000US40043,40043,"Dewey County, Oklahoma",Dewey County, Oklahoma,0,0,0,0,263,31,5,26,0,0,0,0,369,272,118,154,6,0,0,0,292,24,9,15,10,0,0,0
2156,3347,444,215,229,0500000US40045,40045,"Ellis County, Oklahoma",Ellis County, Oklahoma,10,3,3,0,173,61,7,54,0,0,0,0,261,61,27,34,24,0,0,0,74,19,15,4,55,3,2,1
2157,43797,4891,2055,2836,0500000US40047,40047,"Garfield County, Oklahoma",Garfield County, Oklahoma,1305,200,172,28,3633,641,393,248,2350,1023,397,626,7850,1420,641,779,582,26,0,26,1250,118,25,93,2466,772,407,365
2158,20401,2984,1390,1594,0500000US40049,40049,"Garvin County, Oklahoma",Garvin County, Oklahoma,576,136,82,54,2500,438,262,176,0,0,0,0,2585,522,240,282,25,0,0,0,1511,276,131,145,187,10,6,4
2159,44072,4147,1781,2366,0500000US40051,40051,"Grady County, Oklahoma",Grady County, Oklahoma,1125,267,137,130,3820,429,185,244,0,0,0,0,3249,524,302,222,191,27,15,12,2536,314,164,150,441,66,42,24
2160,3671,353,123,230,0500000US40053,40053,"Grant County, Oklahoma",Grant County, Oklahoma,35,2,0,2,240,0,0,0,0,0,0,0,234,32,6,26,7,0,0,0,69,4,1,3,102,26,0,26
2161,3766,604,286,318,0500000US40055,40055,"Greer County, Oklahoma",Greer County, Oklahoma,109,90,44,46,420,62,26,36,0,0,0,0,587,106,30,76,0,0,0,0,16,2,2,0,128,15,5,10
2162,1420,104,27,77,0500000US40057,40057,"Harmon County, Oklahoma",Harmon County, Oklahoma,257,54,29,25,111,23,0,23,0,0,0,0,787,211,93,118,12,0,0,0,52,0,0,0,466,149,65,84
2163,2706,526,249,277,0500000US40059,40059,"Harper County, Oklahoma",Harper County, Oklahoma,0,0,0,0,72,15,12,3,0,0,0,0,869,159,83,76,0,0,0,0,2,0,0,0,290,0,0,0
2164,8713,1435,583,852,0500000US40061,40061,"Haskell County, Oklahoma",Haskell County, Oklahoma,82,39,19,20,2225,749,310,439,2,0,0,0,581,344,156,188,111,8,0,8,1048,175,102,73,134,41,14,27
2165,7575,1420,675,745,0500000US40063,40063,"Hughes County, Oklahoma",Hughes County, Oklahoma,239,76,30,46,874,122,21,101,0,0,0,0,628,201,122,79,0,0,0,0,2601,751,357,394,56,1,0,1
2166,14997,1475,530,945,0500000US40065,40065,"Jackson County, Oklahoma",Jackson County, Oklahoma,1619,383,187,196,2121,673,353,320,24,0,0,0,5983,1663,865,798,336,6,0,6,339,46,24,22,1899,808,359,449
2167,4582,908,356,552,0500000US40067,40067,"Jefferson County, Oklahoma",Jefferson County, Oklahoma,83,15,9,6,424,114,65,49,0,0,0,0,672,199,89,110,1,0,0,0,317,32,24,8,133,26,13,13
2168,7348,1409,599,810,0500000US40069,40069,"Johnston County, Oklahoma",Johnston County, Oklahoma,123,8,0,8,2064,381,157,224,24,24,0,24,601,219,128,91,7,0,0,0,734,147,70,77,132,35,16,19
2169,31802,4424,2031,2393,0500000US40071,40071,"Kay County, Oklahoma",Kay County, Oklahoma,792,167,123,44,3185,784,368,416,0,0,0,0,3627,823,431,392,206,1,1,0,4234,1034,505,529,1294,303,158,145
2170,11752,734,347,387,0500000US40073,40073,"Kingfisher County, Oklahoma",Kingfisher County, Oklahoma,188,8,0,8,908,82,58,24,29,0,0,0,2609,478,237,241,299,268,76,192,311,68,33,35,722,173,70,103
2171,6396,1291,595,696,0500000US40075,40075,"Kiowa County, Oklahoma",Kiowa County, Oklahoma,332,177,75,102,759,287,124,163,0,0,0,0,1021,398,195,203,46,22,0,22,311,36,2,34,154,56,14,42
2172,6278,845,415,430,0500000US40077,40077,"Latimer County, Oklahoma",Latimer County, Oklahoma,71,5,0,5,1151,333,128,205,0,0,0,0,402,80,36,44,65,1,0,1,2158,426,157,269,10,0,0,0
2173,34465,6436,2831,3605,0500000US40079,40079,"Le Flore County, Oklahoma",Le Flore County, Oklahoma,709,119,43,76,4749,860,392,468,56,0,0,0,3525,1079,531,548,355,22,11,11,5484,1284,559,725,897,302,133,169
2174,28225,3921,1582,2339,0500000US40081,40081,"Lincoln County, Oklahoma",Lincoln County, Oklahoma,607,262,141,121,1972,280,128,152,13,0,0,0,1180,173,97,76,84,23,15,8,2506,368,208,160,125,38,18,20
2175,36145,3706,1610,2096,0500000US40083,40083,"Logan County, Oklahoma",Logan County, Oklahoma,2945,1147,518,629,2538,236,191,45,10,0,0,0,3022,738,357,381,252,22,2,20,1557,277,160,117,149,51,40,11
2176,7019,981,479,502,0500000US40085,40085,"Love County, Oklahoma",Love County, Oklahoma,223,90,41,49,839,18,18,0,0,0,0,0,1648,281,127,154,82,0,0,0,517,84,33,51,153,17,3,14
2177,31220,2024,914,1110,0500000US40087,40087,"McClain County, Oklahoma",McClain County, Oklahoma,463,92,57,35,2891,260,161,99,22,0,0,0,3269,627,303,324,46,6,0,6,2364,272,91,181,414,180,90,90
2178,19848,3745,1743,2002,0500000US40089,40089,"McCurtain County, Oklahoma",McCurtain County, Oklahoma,2511,1125,439,686,3608,983,412,571,410,94,52,42,2027,906,491,415,271,28,28,0,4585,1235,585,650,768,303,197,106
2179,12994,2827,1035,1792,0500000US40091,40091,"McIntosh County, Oklahoma",McIntosh County, Oklahoma,453,42,12,30,2094,400,177,223,12,0,0,0,560,167,68,99,13,0,0,0,3320,989,440,549,20,8,0,8
2180,6309,677,363,314,0500000US40093,40093,"Major County, Oklahoma",Major County, Oklahoma,17,0,0,0,405,73,37,36,6,0,0,0,758,219,114,105,76,51,13,38,207,113,43,70,233,48,26,22
2181,10594,1412,547,865,0500000US40095,40095,"Marshall County, Oklahoma",Marshall County, Oklahoma,252,163,58,105,1829,314,166,148,21,0,0,0,3022,496,249,247,25,0,0,0,987,185,68,117,2029,295,150,145
2182,25841,3997,1558,2439,0500000US40097,40097,"Mayes County, Oklahoma",Mayes County, Oklahoma,105,32,27,5,5312,968,434,534,138,41,28,13,1508,290,116,174,159,47,29,18,8116,1711,794,917,270,35,16,19
2183,9555,1304,621,683,0500000US40099,40099,"Murray County, Oklahoma",Murray County, Oklahoma,194,43,21,22,1333,406,117,289,36,36,36,0,957,145,57,88,111,72,35,37,1619,253,129,124,146,52,24,28
2184,35397,6835,2971,3864,0500000US40101,40101,"Muskogee County, Oklahoma",Muskogee County, Oklahoma,6518,1616,586,1030,6779,1537,669,868,26,19,4,15,4159,770,315,455,474,49,33,16,12059,2465,1027,1438,2273,332,146,186
2185,8923,1069,449,620,0500000US40103,40103,"Noble County, Oklahoma",Noble County, Oklahoma,50,19,0,19,986,111,42,69,2,0,0,0,456,38,4,34,11,0,0,0,803,167,77,90,125,26,0,26
2186,6593,1028,492,536,0500000US40105,40105,"Nowata County, Oklahoma",Nowata County, Oklahoma,174,100,30,70,1467,373,166,207,19,9,8,1,337,67,56,11,30,4,4,0,1489,198,82,116,99,20,17,3
2187,6736,1537,831,706,0500000US40107,40107,"Okfuskee County, Oklahoma",Okfuskee County, Oklahoma,596,181,111,70,1533,548,246,302,0,0,0,0,474,103,48,55,0,0,0,0,1675,606,206,400,42,19,19,0
2188,429795,43253,19179,24074,0500000US40109,40109,"Oklahoma County, Oklahoma",Oklahoma County, Oklahoma,116789,31196,13144,18052,60933,12335,5796,6539,829,218,108,110,138408,31215,15059,16156,25921,2771,1022,1749,22399,4063,1583,2480,29917,6116,2867,3249
2189,22870,3292,1370,1922,0500000US40111,40111,"Okmulgee County, Oklahoma",Okmulgee County, Oklahoma,2912,542,239,303,4385,793,422,371,15,15,15,0,1510,461,187,274,133,30,20,10,5587,1305,588,717,165,38,32,6
2190,28936,3392,1530,1862,0500000US40113,40113,"Osage County, Oklahoma",Osage County, Oklahoma,4799,1075,460,615,5045,904,448,456,19,0,0,0,1643,292,165,127,162,12,7,5,5391,840,338,502,453,128,74,54
2191,19354,3268,1485,1783,0500000US40115,40115,"Ottawa County, Oklahoma",Ottawa County, Oklahoma,178,61,38,23,2698,707,332,375,197,49,27,22,1755,634,311,323,216,13,8,5,6218,1480,665,815,728,240,123,117
2192,12323,1715,816,899,0500000US40117,40117,"Pawnee County, Oklahoma",Pawnee County, Oklahoma,113,46,31,15,1582,281,134,147,2,0,0,0,527,105,57,48,47,10,0,10,1766,404,198,206,89,0,0,0
2193,57759,14023,6649,7374,0500000US40119,40119,"Payne County, Oklahoma",Payne County, Oklahoma,2272,825,516,309,5210,1373,734,639,34,18,10,8,3272,972,607,365,3014,1066,480,586,2600,886,378,508,670,210,84,126
2194,29031,4320,1898,2422,0500000US40121,40121,"Pittsburg County, Oklahoma",Pittsburg County, Oklahoma,804,257,177,80,7813,1748,749,999,60,34,19,15,2222,446,232,214,179,47,9,38,2166,496,238,258,199,59,44,15
2195,23743,2850,1212,1638,0500000US40123,40123,"Pontotoc County, Oklahoma",Pontotoc County, Oklahoma,839,104,62,42,5068,803,425,378,17,17,17,0,2106,508,285,223,297,65,17,48,5441,863,361,502,356,44,21,23
2196,50089,7010,3396,3614,0500000US40125,40125,"Pottawatomie County, Oklahoma",Pottawatomie County, Oklahoma,2038,642,350,292,4305,913,479,434,67,26,0,26,3565,638,324,314,526,63,0,63,9940,1919,894,1025,274,64,47,17
2197,7645,1363,697,666,0500000US40127,40127,"Pushmataha County, Oklahoma",Pushmataha County, Oklahoma,77,29,12,17,1180,290,152,138,17,8,0,8,438,46,22,24,48,2,0,2,1703,321,172,149,29,0,0,0
2198,2969,411,146,265,0500000US40129,40129,"Roger Mills County, Oklahoma",Roger Mills County, Oklahoma,10,0,0,0,156,51,14,37,0,0,0,0,256,102,56,46,0,0,0,0,203,65,42,23,82,68,46,22
2199,64323,5014,2067,2947,0500000US40131,40131,"Rogers County, Oklahoma",Rogers County, Oklahoma,803,67,38,29,8921,1039,478,561,64,17,9,8,4359,651,309,342,1396,216,67,149,11498,1515,717,798,934,220,103,117
2200,15276,2789,1104,1685,0500000US40133,40133,"Seminole County, Oklahoma",Seminole County, Oklahoma,1019,322,147,175,1637,460,288,172,12,8,0,8,1282,332,161,171,149,9,0,9,4891,1577,778,799,117,17,0,17
2201,25464,4272,1963,2309,0500000US40135,40135,"Sequoyah County, Oklahoma",Sequoyah County, Oklahoma,861,270,161,109,4144,856,386,470,23,3,0,3,1862,734,344,390,315,11,0,11,8937,1708,838,870,730,378,227,151
2202,33987,4980,2219,2761,0500000US40137,40137,"Stephens County, Oklahoma",Stephens County, Oklahoma,738,31,12,19,2585,323,145,178,72,0,0,0,3421,730,368,362,292,55,38,17,2152,377,164,213,1750,403,145,258
2203,8437,732,335,397,0500000US40139,40139,"Texas County, Oklahoma",Texas County, Oklahoma,850,122,117,5,1194,267,96,171,12,0,0,0,9351,3154,1786,1368,729,551,187,364,121,23,9,14,5532,1960,1220,740
2204,4134,459,191,268,0500000US40141,40141,"Tillman County, Oklahoma",Tillman County, Oklahoma,452,260,140,120,472,139,53,86,0,0,0,0,1978,668,269,399,19,0,0,0,212,62,14,48,1233,442,183,259
2205,391805,39108,17189,21919,0500000US40143,40143,"Tulsa County, Oklahoma",Tulsa County, Oklahoma,63677,17060,7435,9625,58188,11188,5032,6156,639,205,88,117,83923,18508,8784,9724,22920,3562,1639,1923,32991,4959,2024,2935,21893,5469,2677,2792
2206,56198,4713,2076,2637,0500000US40145,40145,"Wagoner County, Oklahoma",Wagoner County, Oklahoma,2718,477,227,250,7578,816,412,404,49,0,0,0,5212,920,424,496,1304,63,22,41,7489,1103,534,569,1528,318,135,183
2207,36746,4532,1776,2756,0500000US40147,40147,"Washington County, Oklahoma",Washington County, Oklahoma,1239,306,131,175,3675,499,184,315,7,0,0,0,3177,600,237,363,1108,153,88,65,5419,802,477,325,978,272,105,167
2208,8895,888,292,596,0500000US40149,40149,"Washita County, Oklahoma",Washita County, Oklahoma,119,0,0,0,626,189,94,95,0,0,0,0,1065,241,120,121,23,0,0,0,189,21,10,11,287,78,26,52
2209,6900,982,440,542,0500000US40151,40151,"Woods County, Oklahoma",Woods County, Oklahoma,169,30,16,14,383,16,8,8,0,0,0,0,521,232,141,91,27,0,0,0,79,7,0,7,13,2,0,2
2210,15647,1524,509,1015,0500000US40153,40153,"Woodward County, Oklahoma",Woodward County, Oklahoma,72,0,0,0,717,203,82,121,2,0,0,0,2572,811,378,433,35,8,8,0,367,119,48,71,719,67,57,10
2211,14112,1951,918,1033,0500000US41001,41001,"Baker County, Oregon",Baker County, Oregon,82,0,0,0,352,70,30,40,27,0,0,0,661,145,105,40,50,4,4,0,254,20,2,18,312,90,66,24
2212,69449,10863,5512,5351,0500000US41003,41003,"Benton County, Oregon",Benton County, Oregon,935,420,241,179,3953,755,328,427,156,25,11,14,6406,1448,715,733,6192,2549,1660,889,609,121,71,50,1989,612,263,349
2213,333633,23195,10586,12609,0500000US41005,41005,"Clackamas County, Oregon",Clackamas County, Oregon,3556,559,202,357,22833,1822,471,1351,918,21,13,8,36537,3801,1449,2352,18458,1753,721,1032,2413,253,43,210,10562,840,234,606
2214,32684,2803,1329,1474,0500000US41007,41007,"Clatsop County, Oregon",Clatsop County, Oregon,188,106,47,59,2632,279,139,140,106,14,0,14,3411,561,287,274,433,7,0,7,244,12,12,0,548,79,46,33
2215,45417,4509,1958,2551,0500000US41009,41009,"Columbia County, Oregon",Columbia County, Oregon,247,0,0,0,2595,368,126,242,136,6,6,0,2765,181,58,123,429,59,21,38,480,34,27,7,405,38,0,38
2216,53428,8475,3711,4764,0500000US41011,41011,"Coos County, Oregon",Coos County, Oregon,204,41,37,4,3886,849,342,507,44,0,0,0,4242,603,254,349,743,54,4,50,1256,247,137,110,1051,97,60,37
2217,20809,1769,832,937,0500000US41013,41013,"Crook County, Oregon",Crook County, Oregon,26,3,0,3,966,48,39,9,68,10,0,10,1818,511,238,273,70,0,0,0,215,80,0,80,285,65,48,17
2218,19463,2187,1104,1083,0500000US41015,41015,"Curry County, Oregon",Curry County, Oregon,33,0,0,0,1578,184,126,58,15,0,0,0,1677,309,124,185,120,14,0,14,465,273,141,132,151,0,0,0
2219,165419,15832,7195,8637,0500000US41017,41017,"Deschutes County, Oregon",Deschutes County, Oregon,997,266,154,112,7158,909,469,440,224,26,0,26,15394,1579,676,903,2017,242,96,146,1279,156,30,126,3249,359,220,139
2220,94813,11358,4886,6472,0500000US41019,41019,"Douglas County, Oregon",Douglas County, Oregon,596,103,77,26,5491,1034,542,492,78,54,18,36,6450,1540,978,562,919,56,39,17,1393,253,138,115,672,87,60,27
2221,1625,153,84,69,0500000US41021,41021,"Gilliam County, Oregon",Gilliam County, Oregon,0,0,0,0,66,42,20,22,11,0,0,0,85,24,11,13,18,9,0,9,64,1,0,1,50,50,11,39
2222,6432,1053,406,647,0500000US41023,41023,"Grant County, Oregon",Grant County, Oregon,0,0,0,0,223,14,11,3,9,0,0,0,277,10,4,6,49,0,0,0,110,57,28,29,52,4,0,4
2223,6183,481,322,159,0500000US41025,41025,"Harney County, Oregon",Harney County, Oregon,11,0,0,0,495,95,25,70,45,2,2,0,364,36,2,34,0,0,0,0,78,23,11,12,8,8,0,8
2224,14641,592,209,383,0500000US41027,41027,"Hood River County, Oregon",Hood River County, Oregon,133,29,15,14,1996,11,8,3,0,0,0,0,7252,554,331,223,304,6,6,0,161,0,0,0,942,63,24,39
2225,173336,21312,9242,12070,0500000US41029,41029,"Jackson County, Oregon",Jackson County, Oregon,1674,485,303,182,9461,1525,804,721,736,28,28,0,28594,6026,2757,3269,2945,266,78,188,2409,486,133,353,3884,727,301,426
2226,13143,1304,643,661,0500000US41031,41031,"Jefferson County, Oregon",Jefferson County, Oregon,87,8,8,0,1945,220,133,87,19,0,0,0,4785,358,122,236,116,0,0,0,3366,1353,619,734,1500,174,23,151
2227,73549,11441,5283,6158,0500000US41033,41033,"Josephine County, Oregon",Josephine County, Oregon,498,115,95,20,4249,775,453,322,67,0,0,0,6579,1388,888,500,718,80,3,77,913,176,100,76,941,162,78,84
2228,51221,9116,4290,4826,0500000US41035,41035,"Klamath County, Oregon",Klamath County, Oregon,433,88,75,13,4670,1031,609,422,54,21,0,21,8803,2459,1144,1315,718,172,78,94,2663,735,421,314,1540,423,181,242
2229,6225,926,363,563,0500000US41037,41037,"Lake County, Oregon",Lake County, Oregon,0,0,0,0,219,71,57,14,0,0,0,0,618,242,108,134,87,4,4,0,180,4,4,0,19,0,0,0
2230,301792,47722,21168,26554,0500000US41039,41039,"Lane County, Oregon",Lane County, Oregon,3681,998,692,306,23044,5827,2417,3410,916,207,57,150,33474,7314,3919,3395,10348,2495,1089,1406,3275,714,343,371,11035,2360,1298,1062
2231,39673,5762,2617,3145,0500000US41041,41041,"Lincoln County, Oregon",Lincoln County, Oregon,139,37,12,25,2802,587,217,370,90,5,5,0,4575,871,340,531,540,219,110,109,1201,321,136,185,1434,77,59,18
2232,105413,12443,5898,6545,0500000US41043,41043,"Linn County, Oregon",Linn County, Oregon,597,13,13,0,6765,987,370,617,146,15,5,10,11750,1804,1002,802,1407,185,78,107,1132,143,102,41,3973,715,505,210
2233,16452,2949,1450,1499,0500000US41045,41045,"Malheur County, Oregon",Malheur County, Oregon,53,37,37,0,1306,210,126,84,0,0,0,0,9571,2576,1207,1369,451,5,2,3,101,73,34,39,834,213,155,58
2234,215548,22483,10255,12228,0500000US41047,41047,"Marion County, Oregon",Marion County, Oregon,3513,1006,555,451,27819,5389,2373,3016,3258,1244,799,445,90691,16461,7522,8939,7375,1168,586,582,2762,470,97,373,26665,5253,2671,2582
2235,6683,731,330,401,0500000US41049,41049,"Morrow County, Oregon",Morrow County, Oregon,29,0,0,0,951,200,136,64,31,0,0,0,4204,860,511,349,92,0,0,0,126,68,17,51,636,102,28,74
2236,549020,54197,25176,29021,0500000US41051,41051,"Multnomah County, Oregon",Multnomah County, Oregon,43242,13274,5868,7406,52010,7649,3210,4439,5194,675,331,344,93496,20847,8893,11954,61869,9449,4701,4748,7043,1815,997,818,20677,4445,2061,2384
2237,64068,6744,2849,3895,0500000US41053,41053,"Polk County, Oregon",Polk County, Oregon,550,344,257,87,4375,807,328,479,365,49,45,4,11959,1402,618,784,1216,358,275,83,1534,285,85,200,3010,258,151,107
2238,1488,107,45,62,0500000US41055,41055,"Sherman County, Oregon",Sherman County, Oregon,1,0,0,0,123,41,18,23,20,10,0,10,107,31,13,18,0,0,0,0,12,3,3,0,9,0,0,0
2239,22093,2273,1129,1144,0500000US41057,41057,"Tillamook County, Oregon",Tillamook County, Oregon,119,44,11,33,1094,70,26,44,115,84,36,48,2658,527,196,331,176,0,0,0,210,83,28,55,466,45,29,16
2240,47407,6420,2760,3660,0500000US41059,41059,"Umatilla County, Oregon",Umatilla County, Oregon,504,167,120,47,4992,778,322,456,111,35,33,2,20049,2976,1146,1830,642,72,1,71,2134,332,151,181,3829,203,65,138
2241,22894,2983,1065,1918,0500000US41061,41061,"Union County, Oregon",Union County, Oregon,183,121,28,93,867,154,41,113,391,48,18,30,1203,212,71,141,295,43,42,1,246,49,19,30,108,6,0,6
2242,6408,526,300,226,0500000US41063,41063,"Wallowa County, Oregon",Wallowa County, Oregon,51,43,8,35,217,26,0,26,20,0,0,0,241,51,30,21,17,5,0,5,49,29,15,14,81,45,30,15
2243,19021,1756,645,1111,0500000US41065,41065,"Wasco County, Oregon",Wasco County, Oregon,26,2,2,0,1171,240,124,116,147,109,46,63,4883,594,330,264,228,22,16,6,848,242,151,91,666,42,24,18
2244,381302,24990,10827,14163,0500000US41067,41067,"Washington County, Oregon",Washington County, Oregon,12671,2250,1131,1119,42499,4518,2279,2239,2319,21,15,6,99293,14807,6413,8394,64206,4703,2279,2424,3346,588,225,363,31226,4629,1981,2648
2245,1208,184,83,101,0500000US41069,41069,"Wheeler County, Oregon",Wheeler County, Oregon,0,0,0,0,72,21,14,7,1,0,0,0,125,0,0,0,4,0,0,0,10,2,0,2,32,0,0,0
2246,77954,7709,3379,4330,0500000US41071,41071,"Yamhill County, Oregon",Yamhill County, Oregon,477,124,34,90,5617,767,396,371,157,27,24,3,16181,3157,1228,1929,1226,139,68,71,1167,151,91,60,4606,441,224,217
2247,87650,6113,2789,3324,0500000US42001,42001,"Adams County, Pennsylvania",Adams County, Pennsylvania,1368,288,138,150,2465,336,120,216,0,0,0,0,6971,1160,666,494,614,76,51,25,147,0,0,0,2232,384,154,230
2248,926541,73918,31277,42641,0500000US42003,42003,"Allegheny County, Pennsylvania",Allegheny County, Pennsylvania,153065,41159,17931,23228,36085,7831,3803,4028,505,67,54,13,25319,4550,1877,2673,45659,7120,3522,3598,1355,418,196,222,9702,1875,717,1158
2249,62643,6772,2883,3889,0500000US42005,42005,"Armstrong County, Pennsylvania",Armstrong County, Pennsylvania,512,232,150,82,858,154,74,80,0,0,0,0,506,50,33,17,201,53,15,38,16,1,1,0,80,15,15,0
2250,144551,11697,4969,6728,0500000US42007,42007,"Beaver County, Pennsylvania",Beaver County, Pennsylvania,9370,2763,1295,1468,5517,1096,596,500,51,0,0,0,2742,365,94,271,684,108,64,44,150,70,29,41,632,46,2,44
2251,46007,5061,2125,2936,0500000US42009,42009,"Bedford County, Pennsylvania",Bedford County, Pennsylvania,323,19,3,16,519,99,10,89,0,0,0,0,583,98,43,55,110,57,21,36,47,0,0,0,61,13,12,1
2252,286775,18175,8321,9854,0500000US42011,42011,"Berks County, Pennsylvania",Berks County, Pennsylvania,20133,3943,1889,2054,25616,6360,2509,3851,101,87,43,44,89308,25092,10902,14190,5949,909,525,384,1394,471,282,189,27353,6574,2947,3627
2253,112760,14038,6105,7933,0500000US42013,42013,"Blair County, Pennsylvania",Blair County, Pennsylvania,2132,714,265,449,2403,1087,402,685,54,17,0,17,1519,497,251,246,656,110,57,53,176,117,74,43,250,100,32,68
2254,57304,6928,3107,3821,0500000US42015,42015,"Bradford County, Pennsylvania",Bradford County, Pennsylvania,353,154,6,148,999,150,100,50,56,0,0,0,878,281,144,137,374,91,33,58,47,11,0,11,300,20,4,16
2255,511560,24874,10121,14753,0500000US42017,42017,"Bucks County, Pennsylvania",Bucks County, Pennsylvania,23548,2634,1239,1395,20922,1563,577,986,161,0,0,0,34276,4753,2115,2638,30084,1768,819,949,508,105,29,76,13043,971,533,438
2256,172617,11937,5000,6937,0500000US42019,42019,"Butler County, Pennsylvania",Butler County, Pennsylvania,1541,382,205,177,3265,609,377,232,17,0,0,0,2816,544,181,363,2402,108,27,81,81,0,0,0,544,125,86,39
2257,116682,15033,6853,8180,0500000US42021,42021,"Cambria County, Pennsylvania",Cambria County, Pennsylvania,3771,1533,554,979,2908,1247,524,723,22,4,0,4,1788,523,256,267,532,55,11,44,16,4,3,1,480,68,40,28
2258,4227,693,372,321,0500000US42023,42023,"Cameron County, Pennsylvania",Cameron County, Pennsylvania,7,7,0,7,200,103,0,103,0,0,0,0,38,15,3,12,11,0,0,0,7,1,0,1,0,0,0,0
2259,57182,6221,2766,3455,0500000US42025,42025,"Carbon County, Pennsylvania",Carbon County, Pennsylvania,1241,445,163,282,1286,247,98,149,7,0,0,0,3156,658,354,304,404,4,2,2,170,46,46,0,326,83,39,44
2260,125729,19725,10558,9167,0500000US42027,42027,"Centre County, Pennsylvania",Centre County, Pennsylvania,3036,1010,524,486,3413,718,455,263,12,0,0,0,3532,811,429,382,8538,3459,1895,1564,95,14,10,4,348,64,44,20
2261,403210,19418,7680,11738,0500000US42029,42029,"Chester County, Pennsylvania",Chester County, Pennsylvania,26499,4350,2128,2222,18068,2094,1135,959,116,14,14,0,38074,6081,3359,2722,29666,916,409,507,377,64,14,50,7861,1174,718,456
2262,35906,5820,2448,3372,0500000US42031,42031,"Clarion County, Pennsylvania",Clarion County, Pennsylvania,456,33,16,17,664,142,2,140,0,0,0,0,363,18,16,2,140,7,0,7,51,7,0,7,26,9,7,2
2263,71023,9693,4474,5219,0500000US42033,42033,"Clearfield County, Pennsylvania",Clearfield County, Pennsylvania,405,173,68,105,1048,205,66,139,9,0,0,0,1188,450,337,113,259,59,13,46,99,35,22,13,173,76,53,23
2264,35387,5481,2345,3136,0500000US42035,42035,"Clinton County, Pennsylvania",Clinton County, Pennsylvania,438,99,58,41,366,40,12,28,7,7,0,7,556,79,31,48,230,0,0,0,65,25,12,13,84,0,0,0
2265,56848,7291,3159,4132,0500000US42037,42037,"Columbia County, Pennsylvania",Columbia County, Pennsylvania,690,460,215,245,963,178,94,84,105,0,0,0,1698,526,244,282,702,205,76,129,34,0,0,0,413,72,52,20
2266,77648,9547,4264,5283,0500000US42039,42039,"Crawford County, Pennsylvania",Crawford County, Pennsylvania,721,148,114,34,1777,356,104,252,25,17,3,14,830,118,47,71,351,22,6,16,33,16,10,6,318,0,0,0
2267,204012,11138,4816,6322,0500000US42041,42041,"Cumberland County, Pennsylvania",Cumberland County, Pennsylvania,7994,2379,1175,1204,7180,818,449,369,40,0,0,0,9260,2234,1018,1216,11359,880,373,507,242,34,10,24,2454,594,297,297
2268,176170,12856,5641,7215,0500000US42043,42043,"Dauphin County, Pennsylvania",Dauphin County, Pennsylvania,52549,12132,5366,6766,10958,1295,655,640,35,0,0,0,26341,6467,2709,3758,13067,1383,761,622,964,171,119,52,7406,2244,1025,1219
2269,359504,21113,8688,12425,0500000US42045,42045,"Delaware County, Pennsylvania",Delaware County, Pennsylvania,117586,23484,9367,14117,17530,2497,890,1607,344,38,0,38,20905,3943,1692,2251,32455,3290,1580,1710,1062,279,140,139,6749,1925,989,936
2270,28816,2783,1276,1507,0500000US42047,42047,"Elk County, Pennsylvania",Elk County, Pennsylvania,156,99,91,8,430,65,58,7,15,0,0,0,229,11,11,0,141,0,0,0,27,0,0,0,2,0,0,0
2271,218021,26515,11549,14966,0500000US42049,42049,"Erie County, Pennsylvania",Erie County, Pennsylvania,17068,6920,2854,4066,9808,2817,1392,1425,64,17,0,17,11356,4357,2069,2288,4621,401,209,192,640,132,45,87,3454,1331,691,640
2272,115991,17247,7181,10066,0500000US42051,42051,"Fayette County, Pennsylvania",Fayette County, Pennsylvania,4078,1850,713,1137,3462,1000,439,561,118,48,48,0,1402,447,127,320,512,102,37,65,23,7,7,0,536,137,115,22
2273,3835,616,227,389,0500000US42053,42053,"Forest County, Pennsylvania",Forest County, Pennsylvania,0,0,0,0,41,8,5,3,0,0,0,0,28,27,23,4,4,2,2,0,3,0,0,0,20,20,20,0
2274,133863,10595,4380,6215,0500000US42055,42055,"Franklin County, Pennsylvania",Franklin County, Pennsylvania,5999,768,314,454,3586,439,129,310,21,7,7,0,9153,2076,1042,1034,1105,37,22,15,306,0,0,0,1461,363,314,49
2275,13799,1444,632,812,0500000US42057,42057,"Fulton County, Pennsylvania",Fulton County, Pennsylvania,181,9,3,6,169,81,59,22,0,0,0,0,176,6,6,0,64,0,0,0,27,1,1,0,94,4,0,4
2276,31651,4101,1635,2466,0500000US42059,42059,"Greene County, Pennsylvania",Greene County, Pennsylvania,133,33,28,5,850,113,70,43,7,1,1,0,219,7,6,1,84,0,0,0,0,0,0,0,96,4,4,0
2277,37872,3977,1640,2337,0500000US42061,42061,"Huntingdon County, Pennsylvania",Huntingdon County, Pennsylvania,420,94,32,62,614,53,29,24,4,0,0,0,491,55,7,48,194,0,0,0,46,34,17,17,79,0,0,0
2278,75149,11407,5293,6114,0500000US42063,42063,"Indiana County, Pennsylvania",Indiana County, Pennsylvania,792,284,198,86,1568,190,71,119,2,0,0,0,804,39,12,27,569,53,0,53,46,26,9,17,324,7,1,6
2279,41463,5719,2442,3277,0500000US42065,42065,"Jefferson County, Pennsylvania",Jefferson County, Pennsylvania,121,46,29,17,614,107,55,52,0,0,0,0,399,24,21,3,105,5,0,5,23,2,2,0,103,39,1,38
2280,22798,2012,826,1186,0500000US42067,42067,"Juniata County, Pennsylvania",Juniata County, Pennsylvania,309,6,6,0,451,37,12,25,0,0,0,0,940,217,99,118,75,13,0,13,3,0,0,0,160,18,12,6
2281,170359,18164,7403,10761,0500000US42069,42069,"Lackawanna County, Pennsylvania",Lackawanna County, Pennsylvania,5345,1405,660,745,7755,2452,1192,1260,54,21,0,21,16268,6468,2933,3535,6119,816,315,501,141,34,29,5,2238,611,252,359
2282,432144,27816,11393,16423,0500000US42071,42071,"Lancaster County, Pennsylvania",Lancaster County, Pennsylvania,21381,4735,2284,2451,17161,2910,1548,1362,113,31,31,0,57338,14178,6711,7467,12147,1205,560,645,440,30,27,3,14798,3573,1482,2091
2283,77047,8770,3582,5188,0500000US42073,42073,"Lawrence County, Pennsylvania",Lawrence County, Pennsylvania,2855,1036,500,536,2839,751,271,480,0,0,0,0,1208,376,162,214,288,7,0,7,46,7,4,3,184,58,30,28
2284,110959,8571,3865,4706,0500000US42075,42075,"Lebanon County, Pennsylvania",Lebanon County, Pennsylvania,3184,464,275,189,4029,945,531,414,21,13,0,13,18816,5309,2230,3079,2041,158,47,111,121,0,0,0,10368,3355,1589,1766
2285,225145,13336,5846,7490,0500000US42077,42077,"Lehigh County, Pennsylvania",Lehigh County, Pennsylvania,25784,5211,2361,2850,24915,5382,2540,2842,112,0,0,0,91979,25453,11943,13510,12020,1169,720,449,1179,480,205,275,21660,5980,2766,3214
2286,247033,26378,11039,15339,0500000US42079,42079,"Luzerne County, Pennsylvania",Luzerne County, Pennsylvania,13695,5629,2760,2869,9972,2790,1157,1633,184,15,0,15,40067,12270,5453,6817,3723,482,255,227,489,190,117,73,12788,4357,1786,2571
2287,97022,11189,5009,6180,0500000US42081,42081,"Lycoming County, Pennsylvania",Lycoming County, Pennsylvania,4464,2102,869,1233,3050,801,354,447,39,0,0,0,2126,291,170,121,848,136,38,98,159,40,8,32,388,129,82,47
2288,36601,5845,2494,3351,0500000US42083,42083,"McKean County, Pennsylvania",McKean County, Pennsylvania,90,4,2,2,652,167,60,107,20,0,0,0,523,158,115,43,143,0,0,0,56,0,0,0,321,83,52,31
2289,93905,10904,4513,6391,0500000US42085,42085,"Mercer County, Pennsylvania",Mercer County, Pennsylvania,5618,2863,1328,1535,1951,580,232,348,5,2,0,2,1203,381,267,114,767,283,176,107,142,15,4,11,268,27,18,9
2290,43491,5835,2535,3300,0500000US42087,42087,"Mifflin County, Pennsylvania",Mifflin County, Pennsylvania,227,40,30,10,852,88,13,75,4,0,0,0,741,312,188,124,166,0,0,0,116,33,33,0,239,124,85,39
2291,107847,10517,4909,5608,0500000US42089,42089,"Monroe County, Pennsylvania",Monroe County, Pennsylvania,23475,2200,880,1320,7926,1057,505,552,71,24,0,24,27823,3869,1610,2259,4268,700,334,366,469,0,0,0,6446,831,352,479
2292,606230,26186,10979,15207,0500000US42091,42091,"Montgomery County, Pennsylvania",Montgomery County, Pennsylvania,70414,8084,3439,4645,27583,2478,1131,1347,344,62,49,13,42508,6883,3066,3817,62932,3927,1729,2198,756,235,51,184,10999,1343,738,605
2293,15937,1559,599,960,0500000US42093,42093,"Montour County, Pennsylvania",Montour County, Pennsylvania,161,7,0,7,149,0,0,0,0,0,0,0,453,180,9,171,639,23,13,10,21,0,0,0,59,2,2,0
2294,222971,13971,6210,7761,0500000US42095,42095,"Northampton County, Pennsylvania",Northampton County, Pennsylvania,16859,2485,1385,1100,13893,1757,1020,737,145,0,0,0,40504,7663,3777,3886,7926,485,223,262,502,27,6,21,8162,1775,779,996
2295,81947,9581,3910,5671,0500000US42097,42097,"Northumberland County, Pennsylvania",Northumberland County, Pennsylvania,753,410,200,210,1923,652,352,300,26,0,0,0,2977,1084,505,579,323,61,46,15,122,35,9,26,885,141,29,112
2296,43434,3601,1647,1954,0500000US42099,42099,"Perry County, Pennsylvania",Perry County, Pennsylvania,331,28,24,4,714,94,66,28,10,0,0,0,906,176,80,96,158,22,22,0,101,34,32,2,203,47,47,0
2297,519186,64730,29268,35462,0500000US42101,42101,"Philadelphia County, Pennsylvania",Philadelphia County, Pennsylvania,640451,177424,77820,99604,65617,12602,5600,7002,578,209,111,98,234212,82109,38046,44063,112847,26183,12525,13658,5103,1235,556,679,113943,46735,21478,25257
2298,43988,3708,1645,2063,0500000US42103,42103,"Pike County, Pennsylvania",Pike County, Pennsylvania,3399,390,90,300,2245,268,162,106,30,15,0,15,6209,882,592,290,680,9,0,9,43,16,0,16,1219,117,101,16
2299,15861,1854,808,1046,0500000US42105,42105,"Potter County, Pennsylvania",Potter County, Pennsylvania,46,9,0,9,272,58,25,33,0,0,0,0,213,10,0,10,70,0,0,0,29,4,2,2,32,0,0,0
2300,124901,14297,6137,8160,0500000US42107,42107,"Schuylkill County, Pennsylvania",Schuylkill County, Pennsylvania,1328,553,150,403,2794,759,341,418,6,5,0,5,5946,2383,1249,1134,560,124,27,97,161,72,44,28,1498,839,603,236
2301,36585,3511,1630,1881,0500000US42109,42109,"Snyder County, Pennsylvania",Snyder County, Pennsylvania,179,36,22,14,494,91,48,43,0,0,0,0,741,192,108,84,226,10,5,5,23,0,0,0,194,119,90,29
2302,66379,6937,2853,4084,0500000US42111,42111,"Somerset County, Pennsylvania",Somerset County, Pennsylvania,242,96,70,26,1046,194,101,93,0,0,0,0,689,137,59,78,271,20,0,20,41,7,0,7,208,53,24,29
2303,5441,535,263,272,0500000US42113,42113,"Sullivan County, Pennsylvania",Sullivan County, Pennsylvania,153,92,61,31,93,13,5,8,2,0,0,0,195,39,37,2,4,0,0,0,7,3,3,0,61,13,11,2
2304,38629,4448,1873,2575,0500000US42115,42115,"Susquehanna County, Pennsylvania",Susquehanna County, Pennsylvania,205,28,10,18,577,98,57,41,3,0,0,0,679,123,52,71,180,29,21,8,9,1,1,0,111,47,8,39
2305,38726,4664,2088,2576,0500000US42117,42117,"Tioga County, Pennsylvania",Tioga County, Pennsylvania,270,62,35,27,512,102,65,37,2,0,0,0,478,136,66,70,241,1,0,1,31,4,4,0,135,29,5,24
2306,33322,3039,1128,1911,0500000US42119,42119,"Union County, Pennsylvania",Union County, Pennsylvania,404,142,82,60,390,62,22,40,4,0,0,0,1389,880,709,171,512,0,0,0,15,10,10,0,385,198,198,0
2307,47964,6037,2712,3325,0500000US42121,42121,"Venango County, Pennsylvania",Venango County, Pennsylvania,460,211,103,108,1001,404,162,242,0,0,0,0,491,87,31,56,170,17,15,2,6,3,0,3,145,36,2,34
2308,37145,4613,2076,2537,0500000US42123,42123,"Warren County, Pennsylvania",Warren County, Pennsylvania,206,73,39,34,874,42,10,32,0,0,0,0,420,115,51,64,164,17,17,0,51,12,11,1,51,25,14,11
2309,186066,15005,6251,8754,0500000US42125,42125,"Washington County, Pennsylvania",Washington County, Pennsylvania,6013,1697,834,863,4412,621,353,268,63,0,0,0,3522,533,292,241,1934,110,65,45,42,7,7,0,824,176,94,82
2310,44491,4390,1991,2399,0500000US42127,42127,"Wayne County, Pennsylvania",Wayne County, Pennsylvania,336,222,119,103,1003,121,12,109,8,0,0,0,1844,319,149,170,301,34,2,32,90,80,34,46,107,12,12,0
2311,321860,28186,11987,16199,0500000US42129,42129,"Westmoreland County, Pennsylvania",Westmoreland County, Pennsylvania,7919,2088,1067,1021,6602,1299,619,680,30,7,0,7,4213,513,305,208,3561,429,285,144,178,35,11,24,756,192,135,57
2312,24219,2420,961,1459,0500000US42131,42131,"Wyoming County, Pennsylvania",Wyoming County, Pennsylvania,339,79,48,31,1078,144,86,58,0,0,0,0,457,93,56,37,118,37,12,25,44,0,0,0,73,0,0,0
2313,363110,23074,9582,13492,0500000US42133,42133,"York County, Pennsylvania",York County, Pennsylvania,24891,4331,2001,2330,15914,2560,1117,1443,270,177,37,140,33797,9036,4084,4952,6513,621,359,262,606,79,62,17,7091,1489,712,777
2314,40827,2766,1060,1706,0500000US44001,44001,"Bristol County, Rhode Island",Bristol County, Rhode Island,534,13,11,2,1234,39,12,27,0,0,0,0,1440,121,77,44,951,241,68,173,43,4,4,0,311,15,12,3
2315,142568,11268,4712,6556,0500000US44003,44003,"Kent County, Rhode Island",Kent County, Rhode Island,2921,194,124,70,4668,474,201,273,13,0,0,0,8609,914,436,478,4776,314,158,156,485,121,60,61,2643,464,276,188
2316,67375,4097,1684,2413,0500000US44005,44005,"Newport County, Rhode Island",Newport County, Rhode Island,3381,865,333,532,2587,260,119,141,165,0,0,0,4585,948,440,508,1376,110,28,82,419,53,53,0,990,239,184,55
2317,365863,31637,14033,17604,0500000US44007,44007,"Providence County, Rhode Island",Providence County, Rhode Island,57427,11876,5274,6602,39328,8349,3850,4499,517,75,26,49,145153,35144,16538,18606,24636,3614,1361,2253,2455,493,299,194,52376,12826,6383,6443
2318,110157,8094,3465,4629,0500000US44009,44009,"Washington County, Rhode Island",Washington County, Rhode Island,1129,438,295,143,2641,358,183,175,67,0,0,0,3472,581,276,305,2422,248,88,160,706,128,55,73,1073,295,198,97
2319,16315,2094,857,1237,0500000US45001,45001,"Abbeville County, South Carolina",Abbeville County, South Carolina,6535,1748,847,901,300,111,74,37,0,0,0,0,370,67,19,48,148,0,0,0,110,110,0,110,167,167,139,28
2320,110356,11041,4959,6082,0500000US45003,45003,"Aiken County, South Carolina",Aiken County, South Carolina,40812,9836,4020,5816,5750,368,192,176,26,0,0,0,9831,1769,894,875,1565,112,74,38,420,25,25,0,1150,170,70,100
2321,1484,171,31,140,0500000US45005,45005,"Allendale County, South Carolina",Allendale County, South Carolina,5939,1991,888,1103,58,0,0,0,8,0,0,0,255,0,0,0,8,0,0,0,46,12,12,0,171,0,0,0
2322,152154,15826,6488,9338,0500000US45007,45007,"Anderson County, South Carolina",Anderson County, South Carolina,31212,7879,3536,4343,4991,990,459,531,49,16,16,0,7625,2224,1098,1126,1890,79,6,73,321,85,17,68,2408,737,305,432
2323,4862,722,415,307,0500000US45009,45009,"Bamberg County, South Carolina",Bamberg County, South Carolina,7927,1952,907,1045,309,34,13,21,0,0,0,0,249,101,75,26,40,0,0,0,55,50,50,0,148,50,25,25
2324,10557,2028,862,1166,0500000US45011,45011,"Barnwell County, South Carolina",Barnwell County, South Carolina,9421,3687,1470,2217,319,27,18,9,0,0,0,0,536,180,1,179,49,0,0,0,43,0,0,0,235,46,1,45
2325,125795,7316,2996,4320,0500000US45013,45013,"Beaufort County, South Carolina",Beaufort County, South Carolina,31912,6324,2794,3530,6464,646,239,407,124,0,0,0,20411,2774,1317,1457,2278,179,41,138,519,52,32,20,7493,1376,655,721
2326,137081,12835,5744,7091,0500000US45015,45015,"Berkeley County, South Carolina",Berkeley County, South Carolina,50996,9565,3486,6079,9883,704,176,528,90,0,0,0,14635,2423,1079,1344,5099,316,200,116,769,140,57,83,7975,1186,294,892
2327,7778,787,351,436,0500000US45017,45017,"Calhoun County, South Carolina",Calhoun County, South Carolina,5681,1603,576,1027,93,40,15,25,61,0,0,0,563,309,110,199,0,0,0,0,85,5,5,0,217,126,56,70
2328,256882,19061,7955,11106,0500000US45019,45019,"Charleston County, South Carolina",Charleston County, South Carolina,103581,23444,9622,13822,9407,2020,1130,890,291,57,0,57,20431,5623,2512,3111,6478,854,398,456,626,288,116,172,6671,1904,774,1130
2329,40877,5722,2326,3396,0500000US45021,45021,"Cherokee County, South Carolina",Cherokee County, South Carolina,11193,3091,1256,1835,1469,416,141,275,12,0,0,0,2567,825,442,383,330,69,0,69,58,0,0,0,727,271,186,85
2330,18796,2035,977,1058,0500000US45023,45023,"Chester County, South Carolina",Chester County, South Carolina,11736,3569,1343,2226,688,195,123,72,0,0,0,0,661,79,44,35,151,0,0,0,123,45,18,27,17,0,0,0
2331,27153,4018,1606,2412,0500000US45025,45025,"Chesterfield County, South Carolina",Chesterfield County, South Carolina,13848,4210,2051,2159,1950,621,316,305,25,0,0,0,2020,730,477,253,207,13,6,7,107,52,18,34,515,287,183,104
2332,15674,1706,639,1067,0500000US45027,45027,"Clarendon County, South Carolina",Clarendon County, South Carolina,14981,4929,1783,3146,595,47,1,46,9,0,0,0,1053,410,208,202,244,0,0,0,36,0,0,0,388,160,84,76
2333,20504,3080,1228,1852,0500000US45029,45029,"Colleton County, South Carolina",Colleton County, South Carolina,14199,3425,1153,2272,512,134,108,26,0,0,0,0,1302,624,438,186,216,71,44,27,123,0,0,0,948,624,438,186
2334,35704,5073,2265,2808,0500000US45031,45031,"Darlington County, South Carolina",Darlington County, South Carolina,26791,7343,2621,4722,1382,911,533,378,19,0,0,0,1300,508,153,355,194,0,0,0,135,88,48,40,7,3,1,2
2335,13594,2844,1410,1434,0500000US45033,45033,"Dillon County, South Carolina",Dillon County, South Carolina,14425,5159,2292,2867,646,291,134,157,0,0,0,0,841,555,283,272,19,1,0,1,532,239,136,103,264,174,98,76
2336,101376,8315,3134,5181,0500000US45035,45035,"Dorchester County, South Carolina",Dorchester County, South Carolina,39833,8452,3548,4904,6158,692,259,433,190,0,0,0,8917,1578,624,954,2948,62,49,13,585,48,13,35,3111,742,396,346
2337,14576,1541,697,844,0500000US45037,45037,"Edgefield County, South Carolina",Edgefield County, South Carolina,8255,1871,882,989,479,82,48,34,23,11,11,0,1348,264,167,97,43,0,0,0,26,0,0,0,445,33,32,1
2338,8441,959,474,485,0500000US45039,45039,"Fairfield County, South Carolina",Fairfield County, South Carolina,12726,2979,968,2011,503,90,17,73,0,0,0,0,504,194,122,72,123,9,9,0,94,65,65,0,0,0,0,0
2339,69703,6612,3010,3602,0500000US45041,45041,"Florence County, South Carolina",Florence County, South Carolina,57057,15207,6899,8308,2215,378,90,288,27,0,0,0,3734,1231,592,639,1945,143,63,80,423,95,34,61,1872,697,382,315
2340,39755,3954,1556,2398,0500000US45043,45043,"Georgetown County, South Carolina",Georgetown County, South Carolina,18873,5196,2088,3108,848,330,156,174,0,0,0,0,1908,369,285,84,291,62,39,23,80,32,11,21,1482,364,274,90
2341,341084,23535,9667,13868,0500000US45045,45045,"Greenville County, South Carolina",Greenville County, South Carolina,87776,19707,7362,12345,18364,3246,1727,1519,1287,474,198,276,47897,10224,4973,5251,13124,907,408,499,2229,245,146,99,18252,4774,2494,2280
2342,40492,4648,2003,2645,0500000US45047,45047,"Greenwood County, South Carolina",Greenwood County, South Carolina,21837,5840,2226,3614,1107,838,467,371,0,0,0,0,4234,2310,1222,1088,769,74,0,74,31,8,0,8,655,186,113,73
2343,7573,998,344,654,0500000US45049,45049,"Hampton County, South Carolina",Hampton County, South Carolina,9389,2033,806,1227,227,92,45,47,0,0,0,0,516,58,12,46,78,0,0,0,0,0,0,0,584,87,32,55
2344,262743,27469,11403,16066,0500000US45051,45051,"Horry County, South Carolina",Horry County, South Carolina,42905,12849,5519,7330,7521,1622,506,1116,107,0,0,0,20758,6168,2969,3199,4973,975,301,674,1489,79,57,22,7085,2359,1324,1035
2345,12745,1422,669,753,0500000US45053,45053,"Jasper County, South Carolina",Jasper County, South Carolina,11621,2581,1243,1338,1138,118,0,118,0,0,0,0,3949,1394,521,873,122,0,0,0,28,0,0,0,1037,502,115,387
2346,44953,4909,2409,2500,0500000US45055,45055,"Kershaw County, South Carolina",Kershaw County, South Carolina,15439,3662,1550,2112,1758,323,196,127,102,0,0,0,3074,1075,544,531,210,0,0,0,213,85,85,0,1711,875,403,472
2347,65526,6238,2619,3619,0500000US45057,45057,"Lancaster County, South Carolina",Lancaster County, South Carolina,18873,4487,2004,2483,2443,650,371,279,0,0,0,0,5281,946,548,398,1458,106,39,67,130,0,0,0,763,0,0,0
2348,43775,7286,3205,4081,0500000US45059,45059,"Laurens County, South Carolina",Laurens County, South Carolina,15148,4211,1842,2369,2609,710,375,335,50,0,0,0,3325,1122,547,575,309,11,10,1,85,28,16,12,1166,341,222,119
2349,5154,842,370,472,0500000US45061,45061,"Lee County, South Carolina",Lee County, South Carolina,10037,3072,1114,1958,189,62,51,11,0,0,0,0,384,61,18,43,37,28,0,28,2,1,1,0,233,0,0,0
2350,217239,19043,7930,11113,0500000US45063,45063,"Lexington County, South Carolina",Lexington County, South Carolina,42285,8111,3413,4698,8936,1829,520,1309,202,0,0,0,17871,5066,2321,2745,5916,622,322,300,1050,119,108,11,5458,1693,911,782
2351,4504,436,193,243,0500000US45065,45065,"McCormick County, South Carolina",McCormick County, South Carolina,3406,629,232,397,293,138,110,28,0,0,0,0,93,30,30,0,21,4,0,4,0,0,0,0,34,34,34,0
2352,11728,1811,783,1028,0500000US45067,45067,"Marion County, South Carolina",Marion County, South Carolina,17416,4541,1911,2630,224,24,24,0,0,0,0,0,748,428,198,230,225,15,15,0,200,178,139,39,376,259,76,183
2353,9665,2323,1158,1165,0500000US45069,45069,"Marlboro County, South Carolina",Marlboro County, South Carolina,11623,3514,1388,2126,1136,499,138,361,0,0,0,0,612,366,131,235,53,0,0,0,847,300,136,164,109,79,40,39
2354,22414,1926,917,1009,0500000US45071,45071,"Newberry County, South Carolina",Newberry County, South Carolina,11500,3607,1658,1949,621,168,46,122,0,0,0,0,2870,953,462,491,59,0,0,0,98,5,0,5,1283,485,224,261
2355,65407,9080,3851,5229,0500000US45073,45073,"Oconee County, South Carolina",Oconee County, South Carolina,5369,946,483,463,2287,769,357,412,12,0,0,0,4303,1133,643,490,605,57,44,13,529,429,233,196,1032,55,18,37
2356,28078,3775,1862,1913,0500000US45075,45075,"Orangeburg County, South Carolina",Orangeburg County, South Carolina,51536,13907,6181,7726,1381,306,160,146,98,98,77,21,1932,1292,746,546,587,61,0,61,496,61,40,21,407,176,174,2
2357,101740,15862,7475,8387,0500000US45077,45077,"Pickens County, South Carolina",Pickens County, South Carolina,7268,1354,476,878,2801,659,287,372,18,0,0,0,4561,488,293,195,2431,1185,812,373,147,0,0,0,1638,93,9,84
2358,157564,17713,8668,9045,0500000US45079,45079,"Richland County, South Carolina",Richland County, South Carolina,186642,37821,15826,21995,11484,1930,1021,909,408,25,0,25,18590,4134,2048,2086,10856,1908,1017,891,843,313,177,136,8791,3076,1620,1456
2359,11716,1266,512,754,0500000US45081,45081,"Saluda County, South Carolina",Saluda County, South Carolina,4934,1187,442,745,809,577,481,96,0,0,0,0,3019,1123,680,443,3,0,0,0,17,10,10,0,1129,430,219,211
2360,208332,21835,10140,11695,0500000US45083,45083,"Spartanburg County, South Carolina",Spartanburg County, South Carolina,59908,14369,5718,8651,11233,2243,1136,1107,81,0,0,0,21539,6147,2848,3299,6984,448,201,247,465,64,18,46,6612,1703,621,1082
2361,46630,3903,1828,2075,0500000US45085,45085,"Sumter County, South Carolina",Sumter County, South Carolina,48762,14071,5969,8102,3454,455,274,181,63,7,7,0,4142,388,205,183,1424,71,40,31,316,73,49,24,1426,187,79,108
2362,17290,3167,1392,1775,0500000US45087,45087,"Union County, South Carolina",Union County, South Carolina,8102,1670,755,915,1209,482,182,300,0,0,0,0,440,88,63,25,4,0,0,0,6,2,0,2,38,0,0,0
2363,9365,1348,507,841,0500000US45089,45089,"Williamsburg County, South Carolina",Williamsburg County, South Carolina,18869,5523,2434,3089,274,78,31,47,0,0,0,0,415,21,11,10,195,73,27,46,118,0,0,0,380,12,0,12
2364,188533,13798,5922,7876,0500000US45091,45091,"York County, South Carolina",York County, South Carolina,50299,8167,3138,5029,8569,619,183,436,66,29,0,29,15572,2140,630,1510,6635,774,520,254,1948,387,135,252,3987,546,248,298
2365,2359,111,47,64,0500000US46003,46003,"Aurora County, South Dakota",Aurora County, South Dakota,29,0,0,0,18,5,0,5,0,0,0,0,163,18,10,8,0,0,0,0,33,8,8,0,43,0,0,0
2366,13718,1388,723,665,0500000US46005,46005,"Beadle County, South Dakota",Beadle County, South Dakota,220,0,0,0,374,125,100,25,164,55,0,55,1914,155,48,107,1027,438,157,281,675,396,256,140,1229,122,42,80
2367,1118,109,55,54,0500000US46007,46007,"Bennett County, South Dakota",Bennett County, South Dakota,27,0,0,0,147,27,4,23,0,0,0,0,275,60,7,53,19,9,7,2,1905,871,357,514,11,0,0,0
2368,5101,684,346,338,0500000US46009,46009,"Bon Homme County, South Dakota",Bon Homme County, South Dakota,29,0,0,0,40,0,0,0,0,0,0,0,83,15,4,11,10,0,0,0,145,45,20,25,1,0,0,0
2369,28363,3492,1767,1725,0500000US46011,46011,"Brookings County, South Dakota",Brookings County, South Dakota,307,51,28,23,605,20,8,12,0,0,0,0,1100,247,101,146,1001,274,262,12,396,252,143,109,189,25,3,22
2370,32749,2331,927,1404,0500000US46013,46013,"Brown County, South Dakota",Brown County, South Dakota,875,186,117,69,894,86,33,53,0,0,0,0,1076,199,127,72,1291,312,0,312,1258,487,240,247,68,0,0,0
2371,4244,602,248,354,0500000US46015,46015,"Brule County, South Dakota",Brule County, South Dakota,59,0,0,0,78,43,19,24,0,0,0,0,140,10,1,9,11,0,0,0,526,110,56,54,0,0,0,0
2372,265,43,25,18,0500000US46017,46017,"Buffalo County, South Dakota",Buffalo County, South Dakota,3,0,0,0,37,9,2,7,0,0,0,0,149,17,8,9,0,0,0,0,1664,691,334,357,10,0,0,0
2373,8910,732,249,483,0500000US46019,46019,"Butte County, South Dakota",Butte County, South Dakota,74,65,37,28,471,14,11,3,0,0,0,0,357,80,38,42,22,22,0,22,235,65,43,22,98,73,39,34
2374,1415,43,22,21,0500000US46021,46021,"Campbell County, South Dakota",Campbell County, South Dakota,0,0,0,0,5,1,1,0,0,0,0,0,23,5,1,4,0,0,0,0,3,0,0,0,11,5,1,4
2375,5601,619,211,408,0500000US46023,46023,"Charles Mix County, South Dakota",Charles Mix County, South Dakota,5,0,0,0,458,79,46,33,5,5,5,0,342,51,29,22,39,20,0,20,2800,1145,601,544,19,0,0,0
2376,3396,170,70,100,0500000US46025,46025,"Clark County, South Dakota",Clark County, South Dakota,12,5,5,0,87,25,9,16,0,0,0,0,126,26,12,14,14,5,5,0,0,0,0,0,55,13,6,7
2377,10117,1800,802,998,0500000US46027,46027,"Clay County, South Dakota",Clay County, South Dakota,226,150,54,96,247,89,54,35,0,0,0,0,341,110,0,110,364,58,58,0,454,225,95,130,178,119,31,88
2378,25466,2893,1146,1747,0500000US46029,46029,"Codington County, South Dakota",Codington County, South Dakota,166,0,0,0,598,87,31,56,0,0,0,0,842,398,160,238,143,0,0,0,665,480,188,292,110,24,0,24
2379,1176,96,36,60,0500000US46031,46031,"Corson County, South Dakota",Corson County, South Dakota,10,0,0,0,55,14,9,5,0,0,0,0,17,2,0,2,0,0,0,0,2830,1560,735,825,2,2,0,2
2380,7793,780,273,507,0500000US46033,46033,"Custer County, South Dakota",Custer County, South Dakota,28,2,0,2,138,44,24,20,0,0,0,0,335,67,34,33,25,0,0,0,333,197,131,66,22,0,0,0
2381,17212,2042,943,1099,0500000US46035,46035,"Davison County, South Dakota",Davison County, South Dakota,251,0,0,0,336,138,103,35,0,0,0,0,647,102,51,51,243,0,0,0,288,202,148,54,204,56,42,14
2382,4589,518,236,282,0500000US46037,46037,"Day County, South Dakota",Day County, South Dakota,7,0,0,0,128,18,6,12,0,0,0,0,120,9,5,4,1,0,0,0,492,254,121,133,45,2,2,0
2383,4076,205,113,92,0500000US46039,46039,"Deuel County, South Dakota",Deuel County, South Dakota,0,0,0,0,67,5,3,2,0,0,0,0,152,8,3,5,0,0,0,0,8,0,0,0,8,2,0,2
2384,1112,81,47,34,0500000US46041,46041,"Dewey County, South Dakota",Dewey County, South Dakota,11,0,0,0,145,0,0,0,14,0,0,0,250,132,97,35,4,0,0,0,4473,1940,941,999,13,6,6,0
2385,2646,202,86,116,0500000US46043,46043,"Douglas County, South Dakota",Douglas County, South Dakota,0,0,0,0,78,0,0,0,0,0,0,0,23,22,21,1,0,0,0,0,63,1,0,1,1,1,0,1
2386,3617,203,108,95,0500000US46045,46045,"Edmunds County, South Dakota",Edmunds County, South Dakota,10,4,4,0,57,4,0,4,0,0,0,0,39,0,0,0,6,0,0,0,33,1,1,0,0,0,0,0
2387,5481,613,263,350,0500000US46047,46047,"Fall River County, South Dakota",Fall River County, South Dakota,0,0,0,0,344,45,36,9,0,0,0,0,144,30,0,30,76,0,0,0,493,377,70,307,1,0,0,0
2388,2154,478,129,349,0500000US46049,46049,"Faulk County, South Dakota",Faulk County, South Dakota,5,0,0,0,73,53,53,0,0,0,0,0,5,0,0,0,0,0,0,0,17,0,0,0,0,0,0,0
2389,6502,434,134,300,0500000US46051,46051,"Grant County, South Dakota",Grant County, South Dakota,42,42,42,0,101,65,65,0,0,0,0,0,325,30,30,0,33,0,0,0,49,36,36,0,204,29,29,0
2390,3616,355,178,177,0500000US46053,46053,"Gregory County, South Dakota",Gregory County, South Dakota,0,0,0,0,132,17,7,10,0,0,0,0,86,28,28,0,0,0,0,0,308,171,88,83,58,0,0,0
2391,1783,351,113,238,0500000US46055,46055,"Haakon County, South Dakota",Haakon County, South Dakota,0,0,0,0,18,0,0,0,0,0,0,0,9,0,0,0,0,0,0,0,86,18,6,12,0,0,0,0
2392,5491,365,216,149,0500000US46057,46057,"Hamlin County, South Dakota",Hamlin County, South Dakota,24,0,0,0,93,30,20,10,0,0,0,0,294,66,30,36,15,0,0,0,1,0,0,0,66,1,1,0
2393,2886,244,124,120,0500000US46059,46059,"Hand County, South Dakota",Hand County, South Dakota,4,0,0,0,30,8,0,8,0,0,0,0,50,18,6,12,23,0,0,0,6,6,6,0,0,0,0,0
2394,3325,407,204,203,0500000US46061,46061,"Hanson County, South Dakota",Hanson County, South Dakota,0,0,0,0,93,5,5,0,0,0,0,0,1,1,1,0,0,0,0,0,0,0,0,0,0,0,0,0
2395,1083,51,2,49,0500000US46063,46063,"Harding County, South Dakota",Harding County, South Dakota,0,0,0,0,26,0,0,0,0,0,0,0,29,0,0,0,0,0,0,0,26,26,26,0,24,0,0,0
2396,13865,1409,668,741,0500000US46065,46065,"Hughes County, South Dakota",Hughes County, South Dakota,6,0,0,0,773,37,0,37,0,0,0,0,449,84,84,0,4,0,0,0,1409,401,125,276,4,0,0,0
2397,6524,468,219,249,0500000US46067,46067,"Hutchinson County, South Dakota",Hutchinson County, South Dakota,0,0,0,0,303,181,63,118,0,0,0,0,177,34,12,22,76,0,0,0,25,0,0,0,4,0,0,0
2398,1239,58,15,43,0500000US46069,46069,"Hyde County, South Dakota",Hyde County, South Dakota,39,0,0,0,35,0,0,0,0,0,0,0,15,13,5,8,0,0,0,0,78,0,0,0,2,0,0,0
2399,1188,200,68,132,0500000US46071,46071,"Jackson County, South Dakota",Jackson County, South Dakota,10,10,10,0,55,12,8,4,0,0,0,0,13,4,0,4,4,0,0,0,1935,1120,503,617,4,4,0,4
2400,1826,126,34,92,0500000US46073,46073,"Jerauld County, South Dakota",Jerauld County, South Dakota,0,0,0,0,10,0,0,0,0,0,0,0,93,42,21,21,0,0,0,0,36,0,0,0,50,24,12,12
2401,743,51,27,24,0500000US46075,46075,"Jones County, South Dakota",Jones County, South Dakota,15,0,0,0,13,0,0,0,0,0,0,0,0,0,0,0,0,0,0,0,97,69,58,11,5,0,0,0
2402,4703,419,175,244,0500000US46077,46077,"Kingsbury County, South Dakota",Kingsbury County, South Dakota,0,0,0,0,43,15,14,1,0,0,0,0,120,31,14,17,11,0,0,0,5,0,0,0,9,0,0,0
2403,11420,1156,781,375,0500000US46079,46079,"Lake County, South Dakota",Lake County, South Dakota,22,0,0,0,313,197,86,111,0,0,0,0,316,0,0,0,6,0,0,0,252,8,3,5,179,0,0,0
2404,22617,2210,1065,1145,0500000US46081,46081,"Lawrence County, South Dakota",Lawrence County, South Dakota,208,93,76,17,671,257,68,189,41,30,30,0,831,196,109,87,233,49,0,49,422,251,147,104,37,10,0,10
2405,53825,2141,828,1313,0500000US46083,46083,"Lincoln County, South Dakota",Lincoln County, South Dakota,922,174,40,134,1464,273,116,157,17,0,0,0,1308,305,187,118,761,0,0,0,112,41,4,37,223,64,1,63
2406,2127,166,48,118,0500000US46085,46085,"Lyman County, South Dakota",Lyman County, South Dakota,5,0,0,0,45,25,13,12,5,5,0,5,95,0,0,0,7,0,0,0,1524,672,324,348,14,0,0,0
2407,5036,388,140,248,0500000US46087,46087,"McCook County, South Dakota",McCook County, South Dakota,36,32,0,32,93,1,1,0,0,0,0,0,216,75,33,42,0,0,0,0,15,0,0,0,69,26,15,11
2408,2096,188,77,111,0500000US46089,46089,"McPherson County, South Dakota",McPherson County, South Dakota,39,32,11,21,18,0,0,0,0,0,0,0,43,0,0,0,20,6,6,0,8,8,8,0,0,0,0,0
2409,3959,158,74,84,0500000US46091,46091,"Marshall County, South Dakota",Marshall County, South Dakota,5,2,2,0,132,0,0,0,0,0,0,0,395,11,6,5,0,0,0,0,354,99,36,63,231,9,6,3
2410,24051,1525,649,876,0500000US46093,46093,"Meade County, South Dakota",Meade County, South Dakota,347,32,21,11,1072,65,13,52,0,0,0,0,1129,62,14,48,265,50,15,35,619,16,1,15,124,33,0,33
2411,776,140,45,95,0500000US46095,46095,"Mellette County, South Dakota",Mellette County, South Dakota,0,0,0,0,4,0,0,0,0,0,0,0,7,0,0,0,0,0,0,0,1177,796,388,408,0,0,0,0
2412,2053,232,130,102,0500000US46097,46097,"Miner County, South Dakota",Miner County, South Dakota,2,0,0,0,36,8,0,8,0,0,0,0,42,4,0,4,9,1,1,0,16,0,0,0,18,0,0,0
2413,152513,10409,4887,5522,0500000US46099,46099,"Minnehaha County, South Dakota",Minnehaha County, South Dakota,11428,1960,858,1102,7710,1641,934,707,41,0,0,0,9580,1553,755,798,3943,314,83,231,3018,1506,799,707,1890,163,51,112
2414,4860,321,108,213,0500000US46101,46101,"Moody County, South Dakota",Moody County, South Dakota,47,15,15,0,466,89,48,41,0,0,0,0,286,93,61,32,141,0,0,0,654,201,122,79,15,0,0,0
2415,581,168,21,147,0500000US46102,46102,"Oglala Lakota County, South Dakota",Oglala Lakota County, South Dakota,9,0,0,0,67,21,21,0,0,0,0,0,558,216,165,51,0,0,0,0,13441,6134,3079,3055,24,0,0,0
2416,87537,7754,3460,4294,0500000US46103,46103,"Pennington County, South Dakota",Pennington County, South Dakota,1496,417,345,72,6762,1798,940,858,159,30,30,0,5970,1545,542,1003,1463,249,52,197,8409,4801,1772,3029,837,9,0,9
2417,2711,276,104,172,0500000US46105,46105,"Perkins County, South Dakota",Perkins County, South Dakota,0,0,0,0,30,3,3,0,0,0,0,0,22,3,3,0,50,0,0,0,92,7,3,4,48,4,0,4
2418,2042,113,57,56,0500000US46107,46107,"Potter County, South Dakota",Potter County, South Dakota,10,0,0,0,73,47,47,0,0,0,0,0,29,0,0,0,32,0,0,0,48,22,22,0,19,0,0,0
2419,5679,307,131,176,0500000US46109,46109,"Roberts County, South Dakota",Roberts County, South Dakota,39,1,1,0,248,78,35,43,0,0,0,0,380,86,68,18,11,0,0,0,3848,1571,653,918,138,24,7,17
2420,2156,202,112,90,0500000US46111,46111,"Sanborn County, South Dakota",Sanborn County, South Dakota,0,0,0,0,27,0,0,0,0,0,0,0,99,18,7,11,10,0,0,0,25,20,0,20,49,0,0,0
2421,5843,461,180,281,0500000US46115,46115,"Spink County, South Dakota",Spink County, South Dakota,9,0,0,0,157,16,8,8,0,0,0,0,207,13,10,3,0,0,0,0,69,0,0,0,61,13,13,0
2422,2634,66,27,39,0500000US46117,46117,"Stanley County, South Dakota",Stanley County, South Dakota,0,0,0,0,81,0,0,0,51,0,0,0,148,0,0,0,0,0,0,0,124,12,12,0,0,0,0,0
2423,1182,134,54,80,0500000US46119,46119,"Sully County, South Dakota",Sully County, South Dakota,0,0,0,0,55,0,0,0,0,0,0,0,15,0,0,0,0,0,0,0,33,0,0,0,0,0,0,0
2424,765,26,11,15,0500000US46121,46121,"Todd County, South Dakota",Todd County, South Dakota,4,1,1,0,4,0,0,0,0,0,0,0,329,260,160,100,268,204,83,121,8916,5625,2629,2996,66,25,0,25
2425,4312,489,178,311,0500000US46123,46123,"Tripp County, South Dakota",Tripp County, South Dakota,0,0,0,0,410,160,88,72,0,0,0,0,81,23,0,23,49,0,0,0,537,372,158,214,0,0,0,0
2426,7727,697,242,455,0500000US46125,46125,"Turner County, South Dakota",Turner County, South Dakota,42,2,2,0,188,27,6,21,0,0,0,0,203,23,3,20,22,0,0,0,58,14,7,7,14,6,3,3
2427,14046,1214,388,826,0500000US46127,46127,"Union County, South Dakota",Union County, South Dakota,120,0,0,0,470,18,3,15,0,0,0,0,545,44,0,44,248,4,3,1,137,0,0,0,103,0,0,0
2428,4225,375,157,218,0500000US46129,46129,"Walworth County, South Dakota",Walworth County, South Dakota,206,0,0,0,195,8,8,0,0,0,0,0,120,40,12,28,17,0,0,0,585,252,43,209,31,0,0,0
2429,19119,1519,612,907,0500000US46135,46135,"Yankton County, South Dakota",Yankton County, South Dakota,197,25,25,0,692,71,44,27,0,0,0,0,955,76,11,65,22,2,0,2,635,443,100,343,87,47,0,47
2430,661,78,24,54,0500000US46137,46137,"Ziebach County, South Dakota",Ziebach County, South Dakota,0,0,0,0,92,77,60,17,3,0,0,0,93,83,59,24,0,0,0,0,1990,1017,520,497,10,10,2,8
2431,66442,9909,4244,5665,0500000US47001,47001,"Anderson County, Tennessee",Anderson County, Tennessee,2618,444,282,162,2521,401,120,281,49,0,0,0,2278,271,139,132,1072,81,20,61,349,242,118,124,712,36,0,36
2432,36986,5230,2092,3138,0500000US47003,47003,"Bedford County, Tennessee",Bedford County, Tennessee,3400,247,153,94,1714,87,16,71,20,20,0,20,6142,964,442,522,96,16,16,0,218,54,54,0,1548,434,150,284
2433,15254,2540,1078,1462,0500000US47005,47005,"Benton County, Tennessee",Benton County, Tennessee,139,48,4,44,173,115,34,81,0,0,0,0,381,19,0,19,26,0,0,0,19,0,0,0,0,0,0,0
2434,12294,2512,1224,1288,0500000US47007,47007,"Bledsoe County, Tennessee",Bledsoe County, Tennessee,844,38,38,0,203,105,48,57,0,0,0,0,351,149,98,51,24,0,0,0,41,4,4,0,26,26,13,13
2435,117513,10379,4323,6056,0500000US47009,47009,"Blount County, Tennessee",Blount County, Tennessee,3340,577,297,280,3700,724,328,396,110,0,0,0,4521,1220,625,595,985,69,34,35,190,0,0,0,382,37,29,8
2436,87970,12373,5628,6745,0500000US47011,47011,"Bradley County, Tennessee",Bradley County, Tennessee,4992,951,405,546,2763,704,447,257,26,26,15,11,6736,2167,929,1238,1194,102,0,102,329,29,0,29,2067,543,206,337
2437,37511,7359,3365,3994,0500000US47013,47013,"Campbell County, Tennessee",Campbell County, Tennessee,60,21,15,6,543,155,54,101,0,0,0,0,584,165,32,133,171,9,0,9,68,2,0,2,172,0,0,0
2438,13327,2176,887,1289,0500000US47015,47015,"Cannon County, Tennessee",Cannon County, Tennessee,274,57,11,46,238,12,10,2,2,2,2,0,333,96,41,55,0,0,0,0,20,0,0,0,45,0,0,0
2439,22785,3450,1551,1899,0500000US47017,47017,"Carroll County, Tennessee",Carroll County, Tennessee,2614,657,315,342,717,255,114,141,23,23,1,22,761,128,73,55,28,18,7,11,69,14,1,13,193,19,6,13
2440,51824,9442,4213,5229,0500000US47019,47019,"Carter County, Tennessee",Carter County, Tennessee,815,311,114,197,779,279,135,144,22,0,0,0,1066,481,303,178,289,3,0,3,138,98,25,73,151,150,118,32
2441,36785,3638,1295,2343,0500000US47021,47021,"Cheatham County, Tennessee",Cheatham County, Tennessee,509,144,57,87,1144,202,88,114,21,0,0,0,1352,205,122,83,210,0,0,0,216,66,40,26,475,130,48,82
2442,13513,1404,510,894,0500000US47023,47023,"Chester County, Tennessee",Chester County, Tennessee,1573,408,181,227,327,148,69,79,0,0,0,0,440,144,143,1,66,17,1,16,0,0,0,0,299,143,143,0
2443,29315,6714,3082,3632,0500000US47025,47025,"Claiborne County, Tennessee",Claiborne County, Tennessee,107,28,1,27,466,160,121,39,36,36,36,0,329,26,26,0,166,45,0,45,49,34,0,34,13,0,0,0
2444,7139,1784,872,912,0500000US47027,47027,"Clay County, Tennessee",Clay County, Tennessee,233,163,137,26,34,5,0,5,0,0,0,0,122,3,3,0,34,0,0,0,0,0,0,0,95,3,3,0
2445,32762,6508,2606,3902,0500000US47029,47029,"Cocke County, Tennessee",Cocke County, Tennessee,646,298,173,125,581,207,70,137,39,0,0,0,905,382,207,175,336,0,0,0,257,143,36,107,4,1,0,1
2446,48597,6289,2987,3302,0500000US47031,47031,"Coffee County, Tennessee",Coffee County, Tennessee,2245,756,169,587,1552,293,174,119,13,12,0,12,2546,883,425,458,677,25,3,22,12,8,8,0,919,228,190,38
2447,10335,1404,734,670,0500000US47033,47033,"Crockett County, Tennessee",Crockett County, Tennessee,1820,470,218,252,547,172,51,121,10,0,0,0,1542,184,85,99,48,0,0,0,25,14,13,1,722,138,61,77
2448,55736,6602,2808,3794,0500000US47035,47035,"Cumberland County, Tennessee",Cumberland County, Tennessee,539,207,152,55,767,85,49,36,0,0,0,0,1801,406,286,120,213,58,58,0,310,118,26,92,282,38,38,0
2449,375972,35482,16111,19371,0500000US47037,47037,"Davidson County, Tennessee",Davidson County, Tennessee,178543,38069,15672,22397,24443,3647,1652,1995,376,243,94,149,69025,15332,6922,8410,23898,2884,1547,1337,958,162,56,106,18785,3818,1731,2087
2450,10500,1927,803,1124,0500000US47039,47039,"Decatur County, Tennessee",Decatur County, Tennessee,391,99,60,39,214,42,12,30,0,0,0,0,383,66,36,30,0,0,0,0,53,53,23,30,133,0,0,0
2451,17334,3153,1408,1745,0500000US47041,47041,"DeKalb County, Tennessee",DeKalb County, Tennessee,320,126,76,50,396,18,0,18,0,0,0,0,1640,601,315,286,77,0,0,0,47,0,0,0,654,512,247,265
2452,47098,5326,2320,3006,0500000US47043,47043,"Dickson County, Tennessee",Dickson County, Tennessee,2140,465,278,187,1402,330,203,127,0,0,0,0,1969,221,58,163,239,0,0,0,144,28,0,28,214,36,0,36
2453,29043,4264,1765,2499,0500000US47045,47045,"Dyer County, Tennessee",Dyer County, Tennessee,4503,1533,814,719,1459,678,352,326,58,0,0,0,1287,226,151,75,244,22,22,0,184,64,46,18,443,24,18,6
2454,27040,1604,718,886,0500000US47047,47047,"Fayette County, Tennessee",Fayette County, Tennessee,10911,2634,1176,1458,569,232,205,27,0,0,0,0,1119,344,185,159,309,0,0,0,272,164,107,57,310,59,14,45
2455,17253,3205,1603,1602,0500000US47049,47049,"Fentress County, Tennessee",Fentress County, Tennessee,26,21,21,0,363,81,36,45,0,0,0,0,291,62,17,45,29,0,0,0,37,0,0,0,50,0,0,0
2456,35198,5088,2217,2871,0500000US47051,47051,"Franklin County, Tennessee",Franklin County, Tennessee,1950,369,119,250,1139,390,176,214,24,0,0,0,1349,279,220,59,136,19,17,2,7,0,0,0,501,220,196,24
2457,36533,4064,1788,2276,0500000US47053,47053,"Gibson County, Tennessee",Gibson County, Tennessee,8022,2271,1002,1269,2066,744,366,378,41,3,3,0,1350,320,168,152,194,27,14,13,197,17,0,17,287,103,98,5
2458,24018,2996,1107,1889,0500000US47055,47055,"Giles County, Tennessee",Giles County, Tennessee,2906,443,211,232,786,150,101,49,0,0,0,0,729,164,83,81,16,0,0,0,65,0,0,0,307,79,62,17
2459,21642,3360,1522,1838,0500000US47057,47057,"Grainger County, Tennessee",Grainger County, Tennessee,44,0,0,0,351,243,89,154,118,0,0,0,796,303,107,196,41,0,0,0,117,0,0,0,1,1,0,1
2460,62426,10323,4395,5928,0500000US47059,47059,"Greene County, Tennessee",Greene County, Tennessee,1447,289,147,142,1160,386,189,197,107,58,58,0,1975,620,290,330,282,38,21,17,76,39,0,39,474,39,15,24
2461,11466,1858,829,1029,0500000US47061,47061,"Grundy County, Tennessee",Grundy County, Tennessee,51,32,32,0,1271,499,240,259,0,0,0,0,180,123,40,83,61,0,0,0,133,0,0,0,11,0,0,0
2462,51210,6002,2435,3567,0500000US47063,47063,"Hamblen County, Tennessee",Hamblen County, Tennessee,2414,972,384,588,2417,429,315,114,249,195,97,98,7398,3321,1546,1775,566,182,63,119,202,31,31,0,1531,1076,478,598
2463,250553,20076,8902,11174,0500000US47065,47065,"Hamilton County, Tennessee",Hamilton County, Tennessee,66559,16550,7529,9021,10946,2525,1256,1269,153,31,0,31,20557,6080,2966,3114,7393,434,191,243,530,110,52,58,4988,1453,603,850
2464,6148,1921,961,960,0500000US47067,47067,"Hancock County, Tennessee",Hancock County, Tennessee,1,1,1,0,18,12,8,4,0,0,0,0,95,20,2,18,38,0,0,0,0,0,0,0,9,9,0,9
2465,11769,1935,915,1020,0500000US47069,47069,"Hardeman County, Tennessee",Hardeman County, Tennessee,8978,1868,746,1122,250,54,30,24,0,0,0,0,255,15,13,2,168,0,0,0,58,4,0,4,44,0,0,0
2466,23049,4000,1643,2357,0500000US47071,47071,"Hardin County, Tennessee",Hardin County, Tennessee,978,197,98,99,349,42,0,42,0,0,0,0,634,106,101,5,116,2,2,0,75,22,22,0,30,0,0,0
2467,53026,9011,4160,4851,0500000US47073,47073,"Hawkins County, Tennessee",Hawkins County, Tennessee,741,194,51,143,966,328,80,248,71,35,0,35,877,230,97,133,258,90,13,77,81,5,0,5,42,24,0,24
2468,7479,1015,333,682,0500000US47075,47075,"Haywood County, Tennessee",Haywood County, Tennessee,8702,1937,870,1067,193,55,19,36,6,6,0,6,749,65,52,13,11,0,0,0,6,0,0,0,440,13,0,13
2469,24042,3946,1553,2393,0500000US47077,47077,"Henderson County, Tennessee",Henderson County, Tennessee,2287,601,256,345,455,293,244,49,14,14,0,14,671,362,223,139,35,0,0,0,0,0,0,0,50,0,0,0
2470,27609,5195,2256,2939,0500000US47079,47079,"Henry County, Tennessee",Henry County, Tennessee,2575,907,458,449,674,223,61,162,0,0,0,0,775,204,87,117,79,6,1,5,103,36,36,0,219,131,72,59
2471,21556,3282,1563,1719,0500000US47081,47081,"Hickman County, Tennessee",Hickman County, Tennessee,529,45,35,10,219,31,7,24,9,0,0,0,574,53,34,19,103,0,0,0,261,0,0,0,41,14,14,0
2472,7264,1137,473,664,0500000US47083,47083,"Houston County, Tennessee",Houston County, Tennessee,312,15,4,11,111,2,2,0,20,0,0,0,124,1,1,0,13,0,0,0,22,12,0,12,0,0,0,0
2473,16695,2520,1114,1406,0500000US47085,47085,"Humphreys County, Tennessee",Humphreys County, Tennessee,321,99,39,60,369,90,63,27,9,0,0,0,467,26,13,13,137,46,0,46,148,0,0,0,185,34,0,34
2474,10934,1665,586,1079,0500000US47087,47087,"Jackson County, Tennessee",Jackson County, Tennessee,14,14,14,0,287,86,23,63,0,0,0,0,221,66,25,41,8,0,0,0,31,6,0,6,175,60,14,46
2475,48251,5964,2457,3507,0500000US47089,47089,"Jefferson County, Tennessee",Jefferson County, Tennessee,687,123,89,34,1178,295,153,142,28,6,0,6,1924,550,291,259,303,7,7,0,14,0,0,0,141,51,30,21
2476,14981,3391,1400,1991,0500000US47091,47091,"Johnson County, Tennessee",Johnson County, Tennessee,55,15,15,0,238,154,40,114,0,0,0,0,306,243,93,150,50,2,2,0,94,13,13,0,10,4,1,3
2477,373346,39197,18179,21018,0500000US47093,47093,"Knox County, Tennessee",Knox County, Tennessee,38630,12504,4774,7730,13115,2780,1319,1461,113,0,0,0,20266,5028,2406,2622,10254,1238,706,532,1154,88,51,37,5315,1264,484,780
2478,3425,955,431,524,0500000US47095,47095,"Lake County, Tennessee",Lake County, Tennessee,826,331,133,198,182,86,17,69,0,0,0,0,90,18,6,12,0,0,0,0,0,0,0,0,32,9,0,9
2479,14064,1968,738,1230,0500000US47097,47097,"Lauderdale County, Tennessee",Lauderdale County, Tennessee,7462,2116,877,1239,636,185,117,68,0,0,0,0,599,150,66,84,55,0,0,0,142,72,17,55,39,8,5,3
2480,40184,6104,2481,3623,0500000US47099,47099,"Lawrence County, Tennessee",Lawrence County, Tennessee,691,286,99,187,848,277,179,98,56,0,0,0,1036,261,115,146,180,156,62,94,121,0,0,0,222,127,78,49
2481,11075,2338,956,1382,0500000US47101,47101,"Lewis County, Tennessee",Lewis County, Tennessee,119,33,33,0,185,0,0,0,0,0,0,0,291,24,14,10,239,0,0,0,0,0,0,0,65,24,24,0
2482,28969,3028,1352,1676,0500000US47103,47103,"Lincoln County, Tennessee",Lincoln County, Tennessee,2200,436,144,292,1076,115,73,42,0,0,0,0,1216,232,127,105,225,100,59,41,52,21,21,0,198,0,0,0
2483,45853,5283,2328,2955,0500000US47105,47105,"Loudon County, Tennessee",Loudon County, Tennessee,546,34,29,5,1852,810,582,228,0,0,0,0,4776,789,673,116,406,0,0,0,117,21,16,5,1385,111,82,29
2484,46178,7450,3490,3960,0500000US47107,47107,"McMinn County, Tennessee",McMinn County, Tennessee,1701,280,121,159,1485,434,228,206,30,0,0,0,2181,248,110,138,435,0,0,0,219,67,54,13,379,117,46,71
2485,22792,4207,1937,2270,0500000US47109,47109,"McNairy County, Tennessee",McNairy County, Tennessee,1464,245,164,81,496,73,37,36,0,0,0,0,573,177,94,83,65,7,0,7,55,1,0,1,137,24,5,19
2486,21780,3195,1294,1901,0500000US47111,47111,"Macon County, Tennessee",Macon County, Tennessee,178,152,58,94,596,207,144,63,0,0,0,0,1248,512,314,198,168,0,0,0,41,0,0,0,266,103,61,42
2487,52291,5313,2243,3070,0500000US47113,47113,"Madison County, Tennessee",Madison County, Tennessee,34741,10933,4556,6377,2389,557,205,352,0,0,0,0,3762,1421,760,661,1007,154,64,90,94,0,0,0,1713,666,237,429
2488,25913,4109,1800,2309,0500000US47115,47115,"Marion County, Tennessee",Marion County, Tennessee,1040,426,88,338,633,110,48,62,0,0,0,0,530,44,4,40,134,6,0,6,12,4,0,4,91,10,0,10
2489,27893,3722,1479,2243,0500000US47117,47117,"Marshall County, Tennessee",Marshall County, Tennessee,1664,307,131,176,1196,543,361,182,0,0,0,0,1868,478,268,210,140,53,23,30,13,0,0,0,535,349,45,304
2490,73659,5229,2244,2985,0500000US47119,47119,"Maury County, Tennessee",Maury County, Tennessee,10377,1711,692,1019,3857,750,265,485,17,0,0,0,5747,1048,464,584,948,37,3,34,145,46,0,46,765,128,36,92
2491,11141,1788,762,1026,0500000US47121,47121,"Meigs County, Tennessee",Meigs County, Tennessee,224,18,18,0,241,46,46,0,0,0,0,0,272,0,0,0,33,0,0,0,45,0,0,0,50,0,0,0
2492,40635,6598,3082,3516,0500000US47123,47123,"Monroe County, Tennessee",Monroe County, Tennessee,902,135,42,93,1362,431,136,295,0,0,0,0,1906,348,157,191,205,127,0,127,86,1,1,0,440,230,134,96
2493,125686,12418,5503,6915,0500000US47125,47125,"Montgomery County, Tennessee",Montgomery County, Tennessee,39274,6323,2927,3396,12277,1992,957,1035,614,96,33,63,20601,3664,1738,1926,4845,542,194,348,865,133,77,56,3745,1224,551,673
2494,5859,493,202,291,0500000US47127,47127,"Moore County, Tennessee",Moore County, Tennessee,91,12,2,10,64,0,0,0,1,0,0,0,0,0,0,0,213,0,0,0,72,0,0,0,0,0,0,0
2495,18089,4073,1510,2563,0500000US47129,47129,"Morgan County, Tennessee",Morgan County, Tennessee,3,3,3,0,181,20,7,13,0,0,0,0,213,92,23,69,0,0,0,0,124,19,0,19,26,11,11,0
2496,24238,3875,1558,2317,0500000US47131,47131,"Obion County, Tennessee",Obion County, Tennessee,3322,1229,498,731,920,189,92,97,5,0,0,0,1388,364,183,181,120,0,0,0,72,39,25,14,448,166,90,76
2497,20972,3967,1851,2116,0500000US47133,47133,"Overton County, Tennessee",Overton County, Tennessee,71,5,5,0,351,148,19,129,139,0,0,0,340,196,81,115,70,1,1,0,24,0,0,0,8,0,0,0
2498,7205,1648,701,947,0500000US47135,47135,"Perry County, Tennessee",Perry County, Tennessee,44,35,4,31,223,145,0,145,0,0,0,0,202,102,17,85,195,0,0,0,72,0,0,0,18,0,0,0
2499,4819,880,275,605,0500000US47137,47137,"Pickett County, Tennessee",Pickett County, Tennessee,0,0,0,0,88,4,0,4,0,0,0,0,161,82,56,26,0,0,0,0,0,0,0,0,0,0,0,0
2500,15352,1921,733,1188,0500000US47139,47139,"Polk County, Tennessee",Polk County, Tennessee,79,0,0,0,645,39,26,13,0,0,0,0,349,83,21,62,27,3,3,0,37,0,0,0,77,60,21,39
2501,65909,10091,4657,5434,0500000US47141,47141,"Putnam County, Tennessee",Putnam County, Tennessee,1682,543,345,198,1840,502,229,273,0,0,0,0,4915,2038,823,1215,968,166,70,96,228,168,30,138,816,365,194,171
2502,28705,4407,1958,2449,0500000US47143,47143,"Rhea County, Tennessee",Rhea County, Tennessee,516,288,61,227,1003,457,119,338,0,0,0,0,1584,366,201,165,158,0,0,0,31,0,0,0,551,58,33,25
2503,48755,6557,3117,3440,0500000US47145,47145,"Roane County, Tennessee",Roane County, Tennessee,1187,271,104,167,1233,74,38,36,18,0,0,0,1030,206,39,167,412,10,0,10,226,38,19,19,237,0,0,0
2504,57872,4983,2158,2825,0500000US47147,47147,"Robertson County, Tennessee",Robertson County, Tennessee,4831,943,354,589,1878,420,275,145,39,0,0,0,4988,1594,874,720,462,31,11,20,223,42,0,42,2124,753,443,310
2505,222137,17593,7932,9661,0500000US47149,47149,"Rutherford County, Tennessee",Rutherford County, Tennessee,47380,7310,3352,3958,13703,1923,912,1011,37,0,0,0,26811,5767,2867,2900,11248,963,375,588,828,51,21,30,5376,696,365,331
2506,20931,4568,1898,2670,0500000US47151,47151,"Scott County, Tennessee",Scott County, Tennessee,62,3,3,0,226,36,22,14,0,0,0,0,210,37,19,18,0,0,0,0,122,104,58,46,15,13,0,13
2507,13685,2980,1489,1491,0500000US47153,47153,"Sequatchie County, Tennessee",Sequatchie County, Tennessee,39,0,0,0,353,31,7,24,0,0,0,0,533,163,163,0,0,0,0,0,26,0,0,0,48,0,0,0
2508,86429,9980,4352,5628,0500000US47155,47155,"Sevier County, Tennessee",Sevier County, Tennessee,740,245,194,51,3071,1449,660,789,44,0,0,0,6190,2672,1173,1499,799,181,88,93,287,4,0,4,763,116,77,39
2509,323948,25226,10481,14745,0500000US47157,47157,"Shelby County, Tennessee",Shelby County, Tennessee,494466,129521,55989,73532,21097,3565,1747,1818,326,10,0,10,59141,14790,7713,7077,25187,2524,952,1572,1616,270,158,112,25725,7327,3774,3553
2510,18092,2395,967,1428,0500000US47159,47159,"Smith County, Tennessee",Smith County, Tennessee,507,211,180,31,534,171,79,92,0,0,0,0,553,238,233,5,89,0,0,0,74,8,8,0,249,119,114,5
2511,12254,1524,683,841,0500000US47161,47161,"Stewart County, Tennessee",Stewart County, Tennessee,49,20,4,16,478,123,44,79,37,0,0,0,433,122,92,30,71,1,1,0,70,0,0,0,89,41,41,0
2512,144749,21365,8972,12393,0500000US47163,47163,"Sullivan County, Tennessee",Sullivan County, Tennessee,2713,861,493,368,3675,931,349,582,107,0,0,0,3082,934,412,522,1013,71,43,28,380,67,25,42,1084,471,217,254
2513,153754,13142,5296,7846,0500000US47165,47165,"Sumner County, Tennessee",Sumner County, Tennessee,14447,3047,1292,1755,6559,506,283,223,156,0,0,0,9588,1775,837,938,2784,250,23,227,409,3,2,1,2663,630,335,295
2514,45757,4122,1738,2384,0500000US47167,47167,"Tipton County, Tennessee",Tipton County, Tennessee,11080,2221,844,1377,1570,293,80,213,0,0,0,0,1673,354,186,168,411,29,0,29,151,32,2,30,562,135,101,34
2515,8163,763,352,411,0500000US47169,47169,"Trousdale County, Tennessee",Trousdale County, Tennessee,594,30,12,18,555,115,74,41,0,0,0,0,43,0,0,0,5,0,0,0,27,10,0,10,0,0,0,0
2516,16076,2785,1176,1609,0500000US47171,47171,"Unicoi County, Tennessee",Unicoi County, Tennessee,40,10,10,0,304,83,66,17,0,0,0,0,926,161,115,46,75,16,16,0,52,0,0,0,260,145,115,30
2517,18673,3430,1488,1942,0500000US47173,47173,"Union County, Tennessee",Union County, Tennessee,59,7,0,7,446,190,36,154,19,0,0,0,333,28,9,19,29,0,0,0,0,0,0,0,4,4,1,3
2518,5431,814,418,396,0500000US47175,47175,"Van Buren County, Tennessee",Van Buren County, Tennessee,0,0,0,0,168,42,27,15,0,0,0,0,78,0,0,0,0,0,0,0,0,0,0,0,32,0,0,0
2519,34304,5941,2474,3467,0500000US47177,47177,"Warren County, Tennessee",Warren County, Tennessee,972,454,201,253,1318,330,112,218,127,126,38,88,3763,1378,710,668,309,80,55,25,92,6,6,0,1263,514,256,258
2520,109626,14449,6349,8100,0500000US47179,47179,"Washington County, Tennessee",Washington County, Tennessee,4676,1051,579,472,3433,1307,424,883,20,0,0,0,4516,1606,869,737,2117,218,129,89,363,241,84,157,1059,220,83,137
2521,13726,2084,828,1256,0500000US47181,47181,"Wayne County, Tennessee",Wayne County, Tennessee,272,132,58,74,289,131,26,105,0,0,0,0,270,21,0,21,63,0,0,0,4,0,0,0,60,3,0,3
2522,27093,4896,2228,2668,0500000US47183,47183,"Weakley County, Tennessee",Weakley County, Tennessee,2346,795,413,382,534,144,88,56,8,8,0,8,853,276,190,86,78,22,15,7,83,10,10,0,281,172,135,37
2523,24855,3440,1538,1902,0500000US47185,47185,"White County, Tennessee",White County, Tennessee,482,109,33,76,691,160,64,96,21,0,0,0,669,215,41,174,63,0,0,0,36,27,6,21,58,0,0,0
2524,193933,6470,2610,3860,0500000US47187,47187,"Williamson County, Tennessee",Williamson County, Tennessee,9472,1373,844,529,6829,736,446,290,49,0,0,0,11289,1787,898,889,10848,844,186,658,893,0,0,0,1769,119,62,57
2525,116328,8138,3550,4588,0500000US47189,47189,"Wilson County, Tennessee",Wilson County, Tennessee,9308,1812,622,1190,3880,739,369,370,22,0,0,0,6229,757,373,384,2617,153,106,47,379,0,0,0,2263,183,83,100
2526,29192,3167,1365,1802,0500000US48001,48001,"Anderson County, Texas",Anderson County, Texas,6913,1850,645,1205,1693,330,210,120,0,0,0,0,6745,1078,352,726,334,28,26,2,197,128,21,107,1170,138,72,66
2527,7141,238,56,182,0500000US48003,48003,"Andrews County, Texas",Andrews County, Texas,412,0,0,0,1049,44,29,15,26,0,0,0,10337,1795,786,1009,57,0,0,0,0,0,0,0,1867,324,134,190
2528,51011,6580,2842,3738,0500000US48005,48005,"Angelina County, Texas",Angelina County, Texas,12586,3041,1094,1947,2745,381,138,243,0,0,0,0,18767,4761,2160,2601,957,87,36,51,270,35,29,6,2408,446,304,142
2529,15951,2505,1179,1326,0500000US48007,48007,"Aransas County, Texas",Aransas County, Texas,38,22,22,0,1501,941,740,201,0,0,0,0,6670,2336,1081,1255,275,12,0,12,218,5,0,5,861,313,0,313
2530,7684,911,342,569,0500000US48009,48009,"Archer County, Texas",Archer County, Texas,89,2,2,0,205,12,8,4,0,0,0,0,705,83,45,38,15,0,0,0,128,0,0,0,36,0,0,0
2531,1666,111,39,72,0500000US48011,48011,"Armstrong County, Texas",Armstrong County, Texas,0,0,0,0,103,12,8,4,0,0,0,0,160,13,9,4,0,0,0,0,15,0,0,0,31,0,0,0
2532,16217,1345,599,746,0500000US48013,48013,"Atascosa County, Texas",Atascosa County, Texas,516,14,0,14,5684,592,274,318,0,0,0,0,32090,3904,1652,2252,237,0,0,0,41,17,12,5,1083,126,20,106
2533,18190,907,418,489,0500000US48015,48015,"Austin County, Texas",Austin County, Texas,2577,1012,422,590,880,179,99,80,0,0,0,0,8112,1337,550,787,165,0,0,0,41,27,27,0,3606,916,411,505
2534,2045,113,0,113,0500000US48017,48017,"Bailey County, Texas",Bailey County, Texas,0,0,0,0,30,0,0,0,0,0,0,0,4456,595,272,323,47,47,11,36,69,0,0,0,244,0,0,0
2535,17181,2409,1037,1372,0500000US48019,48019,"Bandera County, Texas",Bandera County, Texas,154,79,26,53,1180,20,6,14,0,0,0,0,4154,577,460,117,77,0,0,0,274,47,37,10,615,124,94,30
2536,43274,3328,1588,1740,0500000US48021,48021,"Bastrop County, Texas",Bastrop County, Texas,6524,1590,904,686,5949,1094,467,627,0,0,0,0,32643,4452,2160,2292,695,4,3,1,424,0,0,0,15732,2256,1149,1107
2537,2783,344,120,224,0500000US48023,48023,"Baylor County, Texas",Baylor County, Texas,75,17,0,17,36,0,0,0,45,0,0,0,526,167,44,123,0,0,0,0,19,0,0,0,58,42,0,42
2538,8221,1063,429,634,0500000US48025,48025,"Bee County, Texas",Bee County, Texas,515,223,40,183,1376,136,86,50,0,0,0,0,15971,3553,1317,2236,153,5,0,5,149,0,0,0,753,337,188,149
2539,152968,14394,5864,8530,0500000US48027,48027,"Bell County, Texas",Bell County, Texas,83362,15818,6722,9096,26952,3836,1611,2225,2307,411,180,231,87093,16509,7179,9330,9710,1053,415,638,1641,384,252,132,10343,1504,780,724
2540,525595,47518,22221,25297,0500000US48029,48029,"Bexar County, Texas",Bexar County, Texas,145718,27804,14558,13246,196552,27554,12856,14698,2239,374,106,268,1180471,215220,97485,117735,58724,9966,4950,5016,12927,3117,1716,1401,134169,23885,10552,13333
2541,8706,981,325,656,0500000US48031,48031,"Blanco County, Texas",Blanco County, Texas,1,1,1,0,875,169,35,134,47,0,0,0,2307,311,94,217,98,0,0,0,167,0,0,0,521,0,0,0
2542,548,11,6,5,0500000US48033,48033,"Borden County, Texas",Borden County, Texas,0,0,0,0,33,13,13,0,0,0,0,0,85,13,13,0,0,0,0,0,0,0,0,0,0,0,0,0
2543,13854,1637,631,1006,0500000US48035,48035,"Bosque County, Texas",Bosque County, Texas,290,36,13,23,866,135,49,86,0,0,0,0,3441,847,409,438,104,16,8,8,63,26,17,9,367,77,27,50
2544,57020,7451,3064,4387,0500000US48037,48037,"Bowie County, Texas",Bowie County, Texas,21282,6072,2684,3388,2546,542,222,320,38,10,0,10,5770,690,283,407,1102,27,27,0,689,58,6,52,1073,195,109,86
2545,165614,10717,4627,6090,0500000US48039,48039,"Brazoria County, Texas",Brazoria County, Texas,48840,3751,1456,2295,21898,1124,417,707,79,4,0,4,110353,12220,5008,7212,24281,897,468,429,2345,31,15,16,16014,1955,907,1048
2546,115983,24466,12513,11953,0500000US48041,48041,"Brazos County, Texas",Brazos County, Texas,22915,7229,3188,4041,10494,2749,1275,1474,136,0,0,0,54352,13735,6315,7420,12656,3751,2170,1581,523,0,0,0,5749,1987,982,1005
2547,4555,676,243,433,0500000US48043,48043,"Brewster County, Texas",Brewster County, Texas,8,3,3,0,211,37,17,20,0,0,0,0,3989,595,253,342,392,96,25,71,94,34,34,0,308,165,101,64
2548,782,85,54,31,0500000US48045,48045,"Briscoe County, Texas",Briscoe County, Texas,16,14,14,0,99,39,31,8,6,0,0,0,487,119,72,47,0,0,0,0,0,0,0,0,17,11,7,4
2549,515,227,61,166,0500000US48047,48047,"Brooks County, Texas",Brooks County, Texas,79,79,14,65,493,327,277,50,0,0,0,0,6019,2407,1119,1288,0,0,0,0,104,6,0,6,597,249,124,125
2550,25889,2937,1127,1810,0500000US48049,48049,"Brown County, Texas",Brown County, Texas,1132,282,151,131,2087,357,126,231,0,0,0,0,8032,1304,544,760,225,2,0,2,100,8,0,8,529,107,58,49
2551,11572,973,311,662,0500000US48051,48051,"Burleson County, Texas",Burleson County, Texas,2410,580,234,346,796,7,5,2,0,0,0,0,3767,486,227,259,8,0,0,0,41,0,0,0,517,82,48,34
2552,34571,2275,960,1315,0500000US48053,48053,"Burnet County, Texas",Burnet County, Texas,575,43,9,34,2052,377,316,61,16,16,16,0,10437,950,441,509,281,2,0,2,162,19,0,19,2143,139,72,67
2553,15755,1389,694,695,0500000US48055,48055,"Caldwell County, Texas",Caldwell County, Texas,1780,657,462,195,2962,319,255,64,8,0,0,0,21923,4368,2192,2176,409,0,0,0,238,0,0,0,3051,913,357,556
2554,8758,504,236,268,0500000US48057,48057,"Calhoun County, Texas",Calhoun County, Texas,431,101,68,33,2116,105,8,97,0,0,0,0,10442,1356,609,747,1218,111,66,45,40,34,34,0,790,61,0,61
2555,11921,1033,368,665,0500000US48059,48059,"Callahan County, Texas",Callahan County, Texas,105,16,16,0,574,41,41,0,0,0,0,0,1312,213,136,77,59,0,0,0,10,2,0,2,181,45,32,13
2556,36555,5202,2339,2863,0500000US48061,48061,"Cameron County, Texas",Cameron County, Texas,2055,493,247,246,40624,8485,3593,4892,118,0,0,0,376785,105841,47864,57977,2887,201,45,156,732,104,46,58,16757,5987,2892,3095
2557,7098,1143,512,631,0500000US48063,48063,"Camp County, Texas",Camp County, Texas,2179,435,166,269,371,31,3,28,0,0,0,0,3286,1055,354,701,52,0,0,0,55,4,4,0,543,137,28,109
2558,5065,357,132,225,0500000US48065,48065,"Carson County, Texas",Carson County, Texas,64,11,11,0,58,0,0,0,0,0,0,0,603,132,22,110,17,7,0,7,160,0,0,0,167,10,10,0
2559,22589,3273,1704,1569,0500000US48067,48067,"Cass County, Texas",Cass County, Texas,5093,1448,674,774,825,372,141,231,0,0,0,0,1347,443,190,253,171,54,40,14,48,3,3,0,361,18,10,8
2560,2345,204,55,149,0500000US48069,48069,"Castro County, Texas",Castro County, Texas,63,6,0,6,778,56,31,25,0,0,0,0,4881,648,266,382,50,3,0,3,55,0,0,0,246,117,35,82
2561,27950,2485,1106,1379,0500000US48071,48071,"Chambers County, Texas",Chambers County, Texas,3238,482,201,281,1890,130,32,98,0,0,0,0,9785,3061,1440,1621,365,0,0,0,45,0,0,0,1207,709,504,205
2562,30104,3227,1548,1679,0500000US48073,48073,"Cherokee County, Texas",Cherokee County, Texas,6063,1366,618,748,2055,838,418,420,24,12,0,12,11533,2266,1183,1083,237,10,8,2,242,26,0,26,1556,498,231,267
2563,3534,361,158,203,0500000US48075,48075,"Childress County, Texas",Childress County, Texas,158,43,43,0,526,94,56,38,0,0,0,0,1844,393,175,218,0,0,0,0,2,0,0,0,307,72,13,59
2564,9253,991,430,561,0500000US48077,48077,"Clay County, Texas",Clay County, Texas,46,21,21,0,342,20,11,9,0,0,0,0,663,232,106,126,89,0,0,0,69,3,0,3,64,52,16,36
2565,1015,215,104,111,0500000US48079,48079,"Cochran County, Texas",Cochran County, Texas,152,83,44,39,258,70,52,18,0,0,0,0,1679,459,239,220,0,0,0,0,1,0,0,0,121,9,9,0
2566,2401,254,116,138,0500000US48081,48081,"Coke County, Texas",Coke County, Texas,2,2,0,2,36,0,0,0,0,0,0,0,697,118,48,70,0,0,0,0,45,22,0,22,202,61,22,39
2567,6263,913,298,615,0500000US48083,48083,"Coleman County, Texas",Coleman County, Texas,168,22,0,22,505,38,27,11,3,0,0,0,1447,260,104,156,19,0,0,0,98,0,0,0,419,41,3,38
2568,555745,24825,11075,13750,0500000US48085,48085,"Collin County, Texas",Collin County, Texas,97121,7696,3394,4302,55462,4015,1972,2043,769,26,0,26,153312,18118,8364,9754,157684,9397,4304,5093,4219,285,81,204,25173,3359,1194,2165
2569,1599,232,97,135,0500000US48087,48087,"Collingsworth County, Texas",Collingsworth County, Texas,287,159,116,43,310,80,44,36,0,0,0,0,927,197,108,89,0,0,0,0,91,0,0,0,190,25,10,15
2570,11633,877,233,644,0500000US48089,48089,"Colorado County, Texas",Colorado County, Texas,2681,502,128,374,464,132,115,17,0,0,0,0,6226,571,229,342,133,112,66,46,57,0,0,0,2756,241,74,167
2571,98443,5551,2387,3164,0500000US48091,48091,"Comal County, Texas",Comal County, Texas,3161,87,67,20,9079,1043,521,522,65,0,0,0,40969,5115,2441,2674,1739,276,164,112,376,31,13,18,4595,852,424,428
2572,9174,1267,572,695,0500000US48093,48093,"Comanche County, Texas",Comanche County, Texas,167,22,21,1,824,373,109,264,0,0,0,0,3773,627,240,387,79,0,0,0,125,19,19,0,279,30,0,30
2573,1523,235,74,161,0500000US48095,48095,"Concho County, Texas",Concho County, Texas,27,0,0,0,126,15,15,0,0,0,0,0,447,125,63,62,0,0,0,0,16,0,0,0,2,0,0,0
2574,29760,2631,1090,1541,0500000US48097,48097,"Cooke County, Texas",Cooke County, Texas,978,344,159,185,1992,504,287,217,7,7,0,7,7313,1824,834,990,313,4,0,4,302,92,48,44,377,44,23,21
2575,37493,3836,1533,2303,0500000US48099,48099,"Coryell County, Texas",Coryell County, Texas,6239,572,264,308,6255,1036,385,651,471,127,86,41,10536,1296,603,693,1466,230,130,100,548,11,5,6,924,59,31,28
2576,1066,181,97,84,0500000US48101,48101,"Cottle County, Texas",Cottle County, Texas,126,32,13,19,115,29,8,21,0,0,0,0,313,109,14,95,0,0,0,0,3,0,0,0,110,93,6,87
2577,1378,68,37,31,0500000US48103,48103,"Crane County, Texas",Crane County, Texas,49,27,23,4,148,0,0,0,5,0,0,0,3063,109,51,58,99,0,0,0,8,0,0,0,1802,34,14,20
2578,1212,99,27,72,0500000US48105,48105,"Crockett County, Texas",Crockett County, Texas,35,0,0,0,44,0,0,0,0,0,0,0,2085,497,239,258,0,0,0,0,0,0,0,0,1851,497,239,258
2579,2196,224,62,162,0500000US48107,48107,"Crosby County, Texas",Crosby County, Texas,272,31,5,26,331,64,10,54,8,8,0,8,3203,916,402,514,27,0,0,0,0,0,0,0,415,163,117,46
2580,251,13,13,0,0500000US48109,48109,"Culberson County, Texas",Culberson County, Texas,1,0,0,0,271,207,85,122,0,0,0,0,1814,690,287,403,16,0,0,0,55,0,0,0,361,237,118,119
2581,3823,473,246,227,0500000US48111,48111,"Dallam County, Texas",Dallam County, Texas,14,0,0,0,713,143,41,102,0,0,0,0,3287,597,237,360,8,0,0,0,31,0,0,0,667,0,0,0
2582,737648,51785,22728,29057,0500000US48113,48113,"Dallas County, Texas",Dallas County, Texas,584282,111556,48086,63470,170322,24269,11628,12641,1116,65,31,34,1047819,192902,88217,104685,170048,16472,8156,8316,10226,1187,609,578,197971,35913,16145,19768
2583,3909,463,184,279,0500000US48115,48115,"Dawson County, Texas",Dawson County, Texas,372,92,54,38,1080,264,146,118,0,0,0,0,6638,1914,882,1032,0,0,0,0,88,9,0,9,1046,594,297,297
2584,4388,496,253,243,0500000US48117,48117,"Deaf Smith County, Texas",Deaf Smith County, Texas,147,32,15,17,2104,64,15,49,15,0,0,0,13572,1987,853,1134,132,26,25,1,86,0,0,0,974,211,92,119
2585,4186,664,286,378,0500000US48119,48119,"Delta County, Texas",Delta County, Texas,384,154,50,104,344,10,0,10,0,0,0,0,428,16,5,11,19,0,0,0,9,0,0,0,11,0,0,0
2586,495744,29817,13275,16542,0500000US48121,48121,"Denton County, Texas",Denton County, Texas,82502,9376,4379,4997,52926,2941,1413,1528,795,78,17,61,163606,17449,8356,9093,78050,4971,2480,2491,4674,684,265,419,22760,2182,913,1269
2587,10433,1384,552,832,0500000US48123,48123,"DeWitt County, Texas",DeWitt County, Texas,1483,350,165,185,445,78,40,38,0,0,0,0,6220,1510,695,815,3,1,1,0,285,5,5,0,3839,978,476,502
2588,1442,145,44,101,0500000US48125,48125,"Dickens County, Texas",Dickens County, Texas,58,39,14,25,73,14,0,14,0,0,0,0,563,132,34,98,12,1,0,1,9,0,0,0,88,35,9,26
2589,1054,274,55,219,0500000US48127,48127,"Dimmit County, Texas",Dimmit County, Texas,1,1,1,0,1666,1379,428,951,0,0,0,0,8853,4035,1719,2316,164,0,0,0,12,0,0,0,1191,471,373,98
2590,2485,284,139,145,0500000US48129,48129,"Donley County, Texas",Donley County, Texas,167,24,0,24,42,8,3,5,0,0,0,0,306,63,2,61,6,0,0,0,10,1,0,1,43,0,0,0
2591,921,15,15,0,0500000US48131,48131,"Duval County, Texas",Duval County, Texas,1,0,0,0,536,25,0,25,0,0,0,0,9741,2024,788,1236,0,0,0,0,12,0,0,0,81,3,0,3
2592,13975,2213,973,1240,0500000US48133,48133,"Eastland County, Texas",Eastland County, Texas,209,54,38,16,289,51,51,0,0,0,0,0,2822,957,551,406,44,9,8,1,82,18,0,18,457,86,52,34
2593,49893,4369,1884,2485,0500000US48135,48135,"Ector County, Texas",Ector County, Texas,7492,1176,629,547,11900,2067,1046,1021,82,30,0,30,99292,15106,6514,8592,1827,140,80,60,1237,250,42,208,20138,3527,1668,1859
2594,926,173,124,49,0500000US48137,48137,"Edwards County, Texas",Edwards County, Texas,0,0,0,0,0,0,0,0,0,0,0,0,1008,25,25,0,0,0,0,0,0,0,0,0,0,0,0,0
2595,105881,5766,2417,3349,0500000US48139,48139,"Ellis County, Texas",Ellis County, Texas,18467,2772,1206,1566,11020,896,462,434,68,20,0,20,47143,5434,2509,2925,1273,40,9,31,1286,150,74,76,6551,1358,692,666
2596,94407,10430,5131,5299,0500000US48141,48141,"El Paso County, Texas",El Paso County, Texas,24658,3032,1845,1187,100158,19089,8546,10543,1196,528,355,173,683987,144495,62844,81651,10353,1271,581,690,4533,929,404,525,108584,28395,12593,15802
2597,30246,4369,1939,2430,0500000US48143,48143,"Erath County, Texas",Erath County, Texas,319,129,17,112,1134,348,121,227,59,39,39,0,8550,1796,1052,744,310,2,2,0,374,49,12,37,1964,1028,639,389
2598,8059,1253,668,585,0500000US48145,48145,"Falls County, Texas",Falls County, Texas,3665,1290,901,389,432,54,21,33,0,0,0,0,3435,1298,792,506,111,0,0,0,48,22,17,5,409,67,50,17
2599,26151,2651,1260,1391,0500000US48147,48147,"Fannin County, Texas",Fannin County, Texas,1226,404,257,147,1258,182,60,122,0,0,0,0,3283,816,429,387,190,58,44,14,288,16,14,2,311,148,79,69
2600,17581,1481,679,802,0500000US48149,48149,"Fayette County, Texas",Fayette County, Texas,1568,519,187,332,406,2,2,0,0,0,0,0,5349,781,246,535,122,4,0,4,33,5,5,0,396,9,7,2
2601,2527,217,114,103,0500000US48151,48151,"Fisher County, Texas",Fisher County, Texas,114,73,26,47,244,41,12,29,0,0,0,0,1039,143,60,83,12,0,0,0,26,13,7,6,128,20,7,13
2602,2105,145,89,56,0500000US48153,48153,"Floyd County, Texas",Floyd County, Texas,298,122,0,122,267,21,0,21,0,0,0,0,3368,659,260,399,4,0,0,0,0,0,0,0,43,0,0,0
2603,808,41,22,19,0500000US48155,48155,"Foard County, Texas",Foard County, Texas,0,0,0,0,177,31,0,31,0,0,0,0,273,39,16,23,0,0,0,0,4,0,0,0,57,14,11,3
2604,253058,10771,5228,5543,0500000US48157,48157,"Fort Bend County, Texas",Fort Bend County, Texas,156821,14187,6227,7960,47276,4404,2378,2026,152,0,0,0,192070,23460,11209,12251,164852,9048,4548,4500,2674,591,191,400,33167,6981,3486,3495
2605,8324,784,475,309,0500000US48159,48159,"Franklin County, Texas",Franklin County, Texas,468,47,19,28,504,35,7,28,0,0,0,0,1606,31,6,25,0,0,0,0,30,6,0,6,627,6,6,0
2606,12230,1381,554,827,0500000US48161,48161,"Freestone County, Texas",Freestone County, Texas,2474,678,375,303,1034,72,39,33,0,0,0,0,2672,724,398,326,165,49,21,28,65,15,0,15,240,106,38,68
2607,2538,619,326,293,0500000US48163,48163,"Frio County, Texas",Frio County, Texas,5,5,0,5,1839,306,134,172,0,0,0,0,13079,2471,1122,1349,82,11,11,0,0,0,0,0,602,260,167,93
2608,11573,1258,406,852,0500000US48165,48165,"Gaines County, Texas",Gaines County, Texas,416,184,29,155,1018,90,2,88,0,0,0,0,8787,1755,819,936,176,0,0,0,156,0,0,0,647,58,8,50
2609,188427,14296,6345,7951,0500000US48167,48167,"Galveston County, Texas",Galveston County, Texas,40973,7489,3038,4451,20376,2013,1043,970,88,3,3,0,82886,13137,6100,7037,11298,912,444,468,1220,172,108,64,7402,1111,506,605
2610,2291,222,101,121,0500000US48169,48169,"Garza County, Texas",Garza County, Texas,524,246,141,105,153,0,0,0,0,0,0,0,1373,467,288,179,114,0,0,0,4,0,0,0,186,8,5,3
2611,19500,1411,609,802,0500000US48171,48171,"Gillespie County, Texas",Gillespie County, Texas,1,1,0,1,1121,337,148,189,0,0,0,0,6254,1391,611,780,83,0,0,0,627,199,55,144,672,131,61,70
2612,872,90,26,64,0500000US48173,48173,"Glasscock County, Texas",Glasscock County, Texas,0,0,0,0,179,51,0,51,0,0,0,0,554,150,94,56,0,0,0,0,0,0,0,0,249,73,73,0
2613,4361,342,71,271,0500000US48175,48175,"Goliad County, Texas",Goliad County, Texas,427,77,0,77,113,7,7,0,0,0,0,0,2690,475,260,215,29,0,0,0,0,0,0,0,416,51,30,21
2614,8447,690,280,410,0500000US48177,48177,"Gonzales County, Texas",Gonzales County, Texas,1381,446,166,280,978,56,3,53,7,0,0,0,10569,1531,679,852,66,19,0,19,28,0,0,0,4360,955,500,455
2615,13221,1590,625,965,0500000US48179,48179,"Gray County, Texas",Gray County, Texas,635,110,69,41,850,190,87,103,47,0,0,0,5834,1549,582,967,64,0,0,0,328,184,40,144,1086,255,97,158
2616,98018,9560,4168,5392,0500000US48181,48181,"Grayson County, Texas",Grayson County, Texas,6858,2230,897,1333,8336,1385,801,584,9,3,0,3,17783,3312,1483,1829,1932,116,92,24,991,138,72,66,2466,119,43,76
2617,67784,7315,2778,4537,0500000US48183,48183,"Gregg County, Texas",Gregg County, Texas,23305,6048,2499,3549,7811,2552,1085,1467,155,0,0,0,22995,6391,2826,3565,1371,422,184,238,239,77,40,37,1635,366,195,171
2618,14985,1818,774,1044,0500000US48185,48185,"Grimes County, Texas",Grimes County, Texas,3073,948,419,529,1410,115,11,104,0,0,0,0,5728,1029,235,794,15,0,0,0,74,6,1,5,898,211,56,155
2619,80157,4526,2489,2037,0500000US48187,48187,"Guadalupe County, Texas",Guadalupe County, Texas,13366,1306,522,784,13826,1413,723,690,412,37,0,37,61538,8442,3964,4478,2737,181,76,105,417,6,0,6,14137,2272,1198,1074
2620,10305,1071,398,673,0500000US48189,48189,"Hale County, Texas",Hale County, Texas,967,233,171,62,3188,862,181,681,4,0,0,0,19241,4159,1438,2721,106,0,0,0,58,10,0,10,1214,270,162,108
2621,1655,203,81,122,0500000US48191,48191,"Hall County, Texas",Hall County, Texas,185,72,38,34,236,19,16,3,0,0,0,0,1035,266,91,175,0,0,0,0,29,4,4,0,322,82,31,51
2622,6911,983,430,553,0500000US48193,48193,"Hamilton County, Texas",Hamilton County, Texas,21,11,0,11,373,95,47,48,14,0,0,0,1061,535,280,255,2,0,0,0,48,21,15,6,52,3,3,0
2623,2715,190,57,133,0500000US48195,48195,"Hansford County, Texas",Hansford County, Texas,16,0,0,0,284,38,0,38,0,0,0,0,2591,417,192,225,3,0,0,0,48,0,0,0,339,84,30,54
2624,2621,291,123,168,0500000US48197,48197,"Hardeman County, Texas",Hardeman County, Texas,227,107,46,61,193,0,0,0,0,0,0,0,921,154,86,68,0,0,0,0,27,3,3,0,203,60,48,12
2625,48710,5425,2542,2883,0500000US48199,48199,"Hardin County, Texas",Hardin County, Texas,3485,767,269,498,1056,306,0,306,0,0,0,0,3419,558,98,460,420,0,0,0,155,32,0,32,414,0,0,0
2626,1341494,92861,40772,52089,0500000US48201,48201,"Harris County, Texas",Harris County, Texas,873590,167310,72238,95072,339677,60919,28817,32102,2872,329,137,192,2004057,412088,184328,227760,327172,39245,18420,20825,19492,3458,1205,2253,426077,94484,43761,50723
2627,40941,4431,1672,2759,0500000US48203,48203,"Harrison County, Texas",Harrison County, Texas,13159,3822,1461,2361,2629,918,502,416,23,0,0,0,8637,2021,950,1071,534,89,60,29,229,13,0,13,1653,216,96,120
2628,2707,55,12,43,0500000US48205,48205,"Hartley County, Texas",Hartley County, Texas,0,0,0,0,212,139,85,54,0,0,0,0,1050,132,70,62,34,1,0,1,21,0,0,0,89,2,2,0
2629,3593,355,125,230,0500000US48207,48207,"Haskell County, Texas",Haskell County, Texas,198,115,70,45,221,44,28,16,0,0,0,0,1315,306,118,188,2,0,0,0,40,0,0,0,185,26,26,0
2630,114281,12536,4351,8185,0500000US48209,48209,"Hays County, Texas",Hays County, Texas,8014,1430,650,780,17517,2018,905,1113,108,22,0,22,85010,12090,5544,6546,3071,319,133,186,1340,0,0,0,6500,1347,432,915
2631,2362,31,12,19,0500000US48211,48211,"Hemphill County, Texas",Hemphill County, Texas,0,0,0,0,93,8,8,0,0,0,0,0,1442,317,174,143,0,0,0,0,0,0,0,0,451,4,0,4
2632,62205,8656,3825,4831,0500000US48213,48213,"Henderson County, Texas",Henderson County, Texas,4600,1584,801,783,3384,802,358,444,53,0,0,0,10568,3098,1574,1524,496,17,10,7,524,12,12,0,946,152,140,12
2633,49853,7306,3349,3957,0500000US48215,48215,"Hidalgo County, Texas",Hidalgo County, Texas,4037,419,276,143,97460,27461,12248,15213,277,52,0,52,787105,233216,105253,127963,8424,891,408,483,1292,253,117,136,90702,32039,14808,17231
2634,24734,2479,950,1529,0500000US48217,48217,"Hill County, Texas",Hill County, Texas,2047,487,202,285,1208,72,48,24,41,0,0,0,7362,1311,598,713,181,11,0,11,407,28,24,4,1416,220,92,128
2635,10097,930,407,523,0500000US48219,48219,"Hockley County, Texas",Hockley County, Texas,665,259,97,162,1918,371,161,210,19,0,0,0,10950,2090,750,1340,53,8,0,8,99,28,17,11,1257,380,165,215
2636,49941,4441,1948,2493,0500000US48221,48221,"Hood County, Texas",Hood County, Texas,452,12,12,0,1522,58,36,22,48,9,9,0,7416,733,246,487,320,11,3,8,460,59,0,59,413,63,34,29
2637,26399,2308,951,1357,0500000US48223,48223,"Hopkins County, Texas",Hopkins County, Texas,2563,601,244,357,1041,158,73,85,51,0,0,0,6130,1119,576,543,264,72,55,17,111,15,8,7,2114,275,152,123
2638,13050,1373,624,749,0500000US48225,48225,"Houston County, Texas",Houston County, Texas,4776,1721,870,851,378,140,31,109,0,0,0,0,1758,601,294,307,65,11,0,11,17,7,7,0,191,69,15,54
2639,16265,1968,982,986,0500000US48227,48227,"Howard County, Texas",Howard County, Texas,1689,433,181,252,1777,336,148,188,0,0,0,0,12496,2690,1083,1607,132,0,0,0,333,111,47,64,2582,486,174,312
2640,778,213,27,186,0500000US48229,48229,"Hudspeth County, Texas",Hudspeth County, Texas,21,0,0,0,692,132,41,91,0,0,0,0,2822,621,237,384,45,0,0,0,3,0,0,0,580,213,108,105
2641,67052,6287,2668,3619,0500000US48231,48231,"Hunt County, Texas",Hunt County, Texas,6729,1897,896,1001,3381,747,190,557,29,0,0,0,15697,3666,1723,1943,1195,602,334,268,981,238,117,121,7202,2070,1048,1022
2642,14638,1706,575,1131,0500000US48233,48233,"Hutchinson County, Texas",Hutchinson County, Texas,439,27,12,15,1476,512,297,215,81,74,38,36,4941,788,344,444,92,2,0,2,323,30,0,30,687,161,23,138
2643,1053,53,27,26,0500000US48235,48235,"Irion County, Texas",Irion County, Texas,76,76,61,15,0,0,0,0,0,0,0,0,424,66,49,17,0,0,0,0,0,0,0,0,332,25,25,0
2644,6420,676,341,335,0500000US48237,48237,"Jack County, Texas",Jack County, Texas,49,44,23,21,189,6,6,0,0,0,0,0,1111,400,186,214,22,0,0,0,0,0,0,0,137,66,23,43
2645,8525,744,371,373,0500000US48239,48239,"Jackson County, Texas",Jackson County, Texas,997,268,152,116,688,79,29,50,6,0,0,0,4838,966,433,533,62,0,0,0,6,6,1,5,573,37,18,19
2646,26032,4008,1515,2493,0500000US48241,48241,"Jasper County, Texas",Jasper County, Texas,5545,2337,882,1455,814,188,96,92,83,0,0,0,2198,456,254,202,160,30,17,13,55,48,17,31,1350,201,150,51
2647,1576,364,251,113,0500000US48243,48243,"Jeff Davis County, Texas",Jeff Davis County, Texas,0,0,0,0,70,43,43,0,0,0,0,0,593,51,43,8,0,0,0,0,0,0,0,0,137,0,0,0
2648,95839,8307,3435,4872,0500000US48245,48245,"Jefferson County, Texas",Jefferson County, Texas,77903,18957,8114,10843,11445,1959,669,1290,122,0,0,0,49296,12426,5450,6976,9502,2384,1204,1180,639,193,33,160,6528,1726,894,832
2649,268,32,13,19,0500000US48247,48247,"Jim Hogg County, Texas",Jim Hogg County, Texas,20,0,0,0,317,0,0,0,0,0,0,0,4765,1546,752,794,0,0,0,0,0,0,0,0,81,5,0,5
2650,7050,1005,519,486,0500000US48249,48249,"Jim Wells County, Texas",Jim Wells County, Texas,239,46,22,24,1091,101,52,49,0,0,0,0,32560,7633,2816,4817,214,0,0,0,194,37,13,24,934,201,105,96
2651,120156,11552,5012,6540,0500000US48251,48251,"Johnson County, Texas",Johnson County, Texas,5983,528,154,374,6289,366,152,214,689,15,15,0,36645,4866,2358,2508,1522,157,32,125,494,89,82,7,3231,177,65,112
2652,8993,696,272,424,0500000US48253,48253,"Jones County, Texas",Jones County, Texas,367,126,58,68,552,74,40,34,0,0,0,0,3207,580,199,381,4,0,0,0,16,12,12,0,684,133,39,94
2653,4987,304,150,154,0500000US48255,48255,"Karnes County, Texas",Karnes County, Texas,164,0,0,0,556,47,2,45,0,0,0,0,6815,1792,614,1178,77,0,0,0,30,0,0,0,1285,331,111,220
2654,78581,6205,2661,3544,0500000US48257,48257,"Kaufman County, Texas",Kaufman County, Texas,16244,3556,1594,1962,7274,292,95,197,92,8,0,8,28825,3550,1412,2138,1619,225,58,167,381,53,12,41,3496,479,173,306
2655,32427,1562,683,879,0500000US48259,48259,"Kendall County, Texas",Kendall County, Texas,127,4,2,2,2659,64,51,13,47,13,0,13,10889,601,313,288,457,0,0,0,169,0,0,0,1992,342,184,158
2656,12,2,1,1,0500000US48261,48261,"Kenedy County, Texas",Kenedy County, Texas,0,0,0,0,25,0,0,0,0,0,0,0,378,6,1,5,1,0,0,0,0,0,0,0,1,1,0,1
2657,570,41,15,26,0500000US48263,48263,"Kent County, Texas",Kent County, Texas,1,1,0,1,13,0,0,0,0,0,0,0,72,39,6,33,0,0,0,0,0,0,0,0,24,0,0,0
2658,34591,3080,1404,1676,0500000US48265,48265,"Kerr County, Texas",Kerr County, Texas,695,331,104,227,3385,668,185,483,15,0,0,0,13875,2593,1110,1483,363,53,27,26,206,11,11,0,3266,650,416,234
2659,3128,476,190,286,0500000US48267,48267,"Kimble County, Texas",Kimble County, Texas,24,0,0,0,244,14,9,5,0,0,0,0,1101,336,203,133,0,0,0,0,19,0,0,0,300,79,37,42
2660,219,87,68,19,0500000US48269,48269,"King County, Texas",King County, Texas,0,0,0,0,0,0,0,0,0,0,0,0,60,14,2,12,0,0,0,0,0,0,0,0,8,0,0,0
2661,1404,146,130,16,0500000US48271,48271,"Kinney County, Texas",Kinney County, Texas,0,0,0,0,8,0,0,0,0,0,0,0,2032,405,168,237,0,0,0,0,0,0,0,0,36,36,10,26
2662,5759,554,206,348,0500000US48273,48273,"Kleberg County, Texas",Kleberg County, Texas,795,306,133,173,2647,557,104,453,0,0,0,0,21225,6541,2540,4001,678,437,262,175,41,0,0,0,1166,268,149,119
2663,2010,157,71,86,0500000US48275,48275,"Knox County, Texas",Knox County, Texas,195,58,36,22,273,10,0,10,0,0,0,0,1265,229,86,143,45,0,0,0,0,0,0,0,187,5,1,4
2664,36137,6010,2851,3159,0500000US48277,48277,"Lamar County, Texas",Lamar County, Texas,6243,1759,804,955,2008,375,168,207,19,0,0,0,3932,830,460,370,376,0,0,0,654,141,24,117,556,14,3,11
2665,4934,752,269,483,0500000US48279,48279,"Lamb County, Texas",Lamb County, Texas,398,91,58,33,882,160,42,118,0,0,0,0,7237,1636,567,1069,95,12,12,0,61,30,26,4,205,43,17,26
2666,15098,1564,749,815,0500000US48281,48281,"Lampasas County, Texas",Lampasas County, Texas,862,31,26,5,1296,253,161,92,80,22,22,0,4109,449,293,156,238,10,10,0,256,88,80,8,444,7,0,7
2667,808,22,3,19,0500000US48283,48283,"La Salle County, Texas",La Salle County, Texas,0,0,0,0,758,0,0,0,0,0,0,0,5736,1190,562,628,0,0,0,0,0,0,0,0,508,252,86,166
2668,14450,869,358,511,0500000US48285,48285,"Lavaca County, Texas",Lavaca County, Texas,1152,281,116,165,718,141,88,53,2,2,0,2,3707,614,302,312,90,15,0,15,52,0,0,0,1825,268,134,134
2669,10701,667,255,412,0500000US48287,48287,"Lee County, Texas",Lee County, Texas,1837,507,227,280,381,68,9,59,0,0,0,0,3898,742,281,461,215,0,0,0,22,0,0,0,331,58,23,35
2670,13090,1532,696,836,0500000US48289,48289,"Leon County, Texas",Leon County, Texas,1155,462,209,253,258,129,23,106,37,0,0,0,2539,934,491,443,145,0,0,0,38,0,0,0,765,377,266,111
2671,49404,5906,2892,3014,0500000US48291,48291,"Liberty County, Texas",Liberty County, Texas,6460,1120,527,593,2686,484,236,248,0,0,0,0,20725,4064,1897,2167,396,96,19,77,452,214,126,88,7659,1076,303,773
2672,12937,2117,962,1155,0500000US48293,48293,"Limestone County, Texas",Limestone County, Texas,3923,1037,513,524,1106,151,64,87,36,24,13,11,5018,1124,564,560,144,32,15,17,411,3,3,0,340,54,25,29
2673,2048,164,55,109,0500000US48295,48295,"Lipscomb County, Texas",Lipscomb County, Texas,55,0,0,0,169,11,6,5,0,0,0,0,990,187,72,115,32,8,0,8,42,2,0,2,353,85,39,46
2674,6642,901,483,418,0500000US48297,48297,"Live Oak County, Texas",Live Oak County, Texas,6,4,4,0,47,0,0,0,0,0,0,0,3928,1335,443,892,165,24,0,24,0,0,0,0,115,4,4,0
2675,18158,1220,530,690,0500000US48299,48299,"Llano County, Texas",Llano County, Texas,93,0,0,0,811,90,23,67,0,0,0,0,2297,327,189,138,22,8,8,0,209,12,5,7,618,121,66,55
2676,117,0,0,0,0500000US48301,48301,"Loving County, Texas",Loving County, Texas,0,0,0,0,0,0,0,0,0,0,0,0,0,0,0,0,0,0,0,0,0,0,0,0,0,0,0,0
2677,156443,21720,10317,11403,0500000US48303,48303,"Lubbock County, Texas",Lubbock County, Texas,20668,5539,2729,2810,18072,3893,1503,2390,334,108,40,68,107073,25553,11342,14211,6710,1763,1006,757,2405,452,280,172,16630,3527,1471,2056
2678,2918,253,140,113,0500000US48305,48305,"Lynn County, Texas",Lynn County, Texas,50,14,14,0,674,137,56,81,20,4,4,0,2715,655,264,391,25,2,2,0,11,11,11,0,172,50,28,22
2679,4684,653,240,413,0500000US48307,48307,"McCulloch County, Texas",McCulloch County, Texas,53,1,0,1,411,107,61,46,0,0,0,0,2575,447,185,262,70,33,33,0,29,0,0,0,937,207,8,199
2680,135216,16371,7360,9011,0500000US48309,48309,"McLennan County, Texas",McLennan County, Texas,34741,11880,4821,7059,14599,2370,1120,1250,138,0,0,0,65538,15032,7283,7749,3629,888,395,493,919,377,226,151,6802,1693,802,891
2681,254,17,0,17,0500000US48311,48311,"McMullen County, Texas",McMullen County, Texas,0,0,0,0,62,0,0,0,0,0,0,0,470,59,37,22,0,0,0,0,0,0,0,0,19,0,0,0
2682,7005,615,292,323,0500000US48313,48313,"Madison County, Texas",Madison County, Texas,1036,211,90,121,595,96,37,59,0,0,0,0,2404,288,84,204,557,0,0,0,43,0,0,0,416,115,52,63
2683,7006,1135,535,600,0500000US48315,48315,"Marion County, Texas",Marion County, Texas,2248,645,265,380,177,3,0,3,40,0,0,0,412,34,14,20,28,0,0,0,21,10,0,10,247,0,0,0
2684,2885,122,61,61,0500000US48317,48317,"Martin County, Texas",Martin County, Texas,15,0,0,0,57,0,0,0,8,0,0,0,2697,453,157,296,3,0,0,0,172,0,0,0,672,119,57,62
2685,3249,141,57,84,0500000US48319,48319,"Mason County, Texas",Mason County, Texas,0,0,0,0,176,17,0,17,0,0,0,0,867,101,29,72,58,0,0,0,90,0,0,0,159,20,1,19
2686,15587,1492,672,820,0500000US48321,48321,"Matagorda County, Texas",Matagorda County, Texas,3784,1415,520,895,1706,138,138,0,173,142,77,65,15764,3342,1668,1674,697,128,101,27,98,0,0,0,6929,1913,962,951
2687,1447,476,185,291,0500000US48323,48323,"Maverick County, Texas",Maverick County, Texas,362,0,0,0,6632,1653,671,982,0,0,0,0,55156,14554,6279,8275,29,0,0,0,1097,140,45,95,2779,605,213,392
2688,21085,1324,461,863,0500000US48325,48325,"Medina County, Texas",Medina County, Texas,309,28,18,10,4732,353,309,44,0,0,0,0,25601,3753,1762,1991,336,4,0,4,353,0,0,0,1763,244,23,221
2689,1252,127,43,84,0500000US48327,48327,"Menard County, Texas",Menard County, Texas,0,0,0,0,159,10,0,10,0,0,0,0,720,151,61,90,0,0,0,0,0,0,0,0,274,24,19,5
2690,75013,3478,1591,1887,0500000US48329,48329,"Midland County, Texas",Midland County, Texas,10992,1373,636,737,10732,1531,421,1110,51,0,0,0,77091,11344,4761,6583,3542,144,48,96,1051,40,25,15,11760,1432,696,736
2691,14980,1741,781,960,0500000US48331,48331,"Milam County, Texas",Milam County, Texas,2452,436,146,290,600,167,84,83,43,0,0,0,6549,1537,745,792,147,30,30,0,98,0,0,0,492,0,0,0
2692,3515,379,181,198,0500000US48333,48333,"Mills County, Texas",Mills County, Texas,1,1,1,0,232,0,0,0,0,0,0,0,1074,157,99,58,6,3,0,3,4,0,0,0,73,0,0,0
2693,3411,436,188,248,0500000US48335,48335,"Mitchell County, Texas",Mitchell County, Texas,247,44,44,0,428,68,0,68,0,0,0,0,2651,251,87,164,0,0,0,0,38,0,0,0,232,121,75,46
2694,16521,2295,948,1347,0500000US48337,48337,"Montague County, Texas",Montague County, Texas,134,28,19,9,618,5,3,2,0,0,0,0,2149,378,92,286,0,0,0,0,76,0,0,0,504,104,24,80
2695,380480,21797,8775,13022,0500000US48339,48339,"Montgomery County, Texas",Montgomery County, Texas,30289,4769,1844,2925,35172,4090,2167,1923,182,18,0,18,144047,24531,11519,13012,17714,472,246,226,2543,334,88,246,17599,2911,1654,1257
2696,6642,585,253,332,0500000US48341,48341,"Moore County, Texas",Moore County, Texas,798,60,60,0,926,382,194,188,0,0,0,0,11957,1344,762,582,1325,186,116,70,75,0,0,0,2050,236,184,52
2697,7812,824,295,529,0500000US48343,48343,"Morris County, Texas",Morris County, Texas,2746,1005,405,600,247,9,5,4,7,0,0,0,1247,308,193,115,15,0,0,0,25,0,0,0,484,299,184,115
2698,1071,61,28,33,0500000US48345,48345,"Motley County, Texas",Motley County, Texas,10,0,0,0,65,8,0,8,0,0,0,0,207,20,18,2,0,0,0,0,0,0,0,0,94,10,4,6
2699,35226,6007,2563,3444,0500000US48347,48347,"Nacogdoches County, Texas",Nacogdoches County, Texas,10817,4566,1700,2866,2510,1045,479,566,14,3,0,3,11560,3650,1577,2073,850,123,10,113,678,496,279,217,1201,250,141,109
2700,26823,3039,1098,1941,0500000US48349,48349,"Navarro County, Texas",Navarro County, Texas,5679,1663,637,1026,1679,276,129,147,801,189,87,102,13660,2395,1206,1189,313,9,0,9,291,51,19,32,4373,847,565,282
2701,10019,2062,1102,960,0500000US48351,48351,"Newton County, Texas",Newton County, Texas,2869,1174,658,516,316,236,96,140,0,0,0,0,513,225,72,153,83,25,0,25,26,0,0,0,50,0,0,0
2702,7980,1028,360,668,0500000US48353,48353,"Nolan County, Texas",Nolan County, Texas,784,185,134,51,425,88,50,38,0,0,0,0,5658,1010,474,536,21,0,0,0,90,32,5,27,710,113,80,33
2703,101577,11046,4658,6388,0500000US48355,48355,"Nueces County, Texas",Nueces County, Texas,12523,3386,1541,1845,32198,8094,3560,4534,311,0,0,0,228591,41249,17881,23368,7412,1188,448,740,1263,193,6,187,8792,1762,798,964
2704,4140,366,127,239,0500000US48357,48357,"Ochiltree County, Texas",Ochiltree County, Texas,112,0,0,0,746,178,15,163,0,0,0,0,5411,930,418,512,23,0,0,0,76,0,0,0,915,115,29,86
2705,1341,158,81,77,0500000US48359,48359,"Oldham County, Texas",Oldham County, Texas,4,1,0,1,25,1,1,0,0,0,0,0,286,45,16,29,20,0,0,0,4,0,0,0,2,0,0,0
2706,66244,6885,2788,4097,0500000US48361,48361,"Orange County, Texas",Orange County, Texas,7193,1878,987,891,2680,744,238,506,0,0,0,0,6677,901,337,564,997,24,19,5,215,49,11,38,848,67,33,34
2707,21178,2538,1208,1330,0500000US48363,48363,"Palo Pinto County, Texas",Palo Pinto County, Texas,643,125,50,75,1078,108,61,47,5,0,0,0,5683,1159,421,738,245,24,22,2,138,22,0,22,400,111,20,91
2708,16657,1926,660,1266,0500000US48365,48365,"Panola County, Texas",Panola County, Texas,3631,715,269,446,458,89,36,53,0,0,0,0,1970,508,176,332,105,55,23,32,32,2,2,0,254,46,23,23
2709,113311,7830,2874,4956,0500000US48367,48367,"Parker County, Texas",Parker County, Texas,1752,440,371,69,5480,896,356,540,48,5,0,5,17396,2525,1164,1361,724,108,55,53,1012,9,2,7,1924,188,104,84
2710,3189,171,74,97,0500000US48369,48369,"Parmer County, Texas",Parmer County, Texas,66,0,0,0,900,203,114,89,0,0,0,0,6131,982,454,528,61,39,0,39,23,0,0,0,477,52,0,52
2711,3370,277,136,141,0500000US48371,48371,"Pecos County, Texas",Pecos County, Texas,95,0,0,0,941,25,0,25,0,0,0,0,9656,1914,841,1073,105,0,0,0,88,0,0,0,1126,285,126,159
2712,34449,5703,2443,3260,0500000US48373,48373,"Polk County, Texas",Polk County, Texas,3471,804,289,515,1677,243,117,126,0,0,0,0,6636,1081,565,516,356,0,0,0,768,130,61,69,1008,90,48,42
2713,48859,6354,2950,3404,0500000US48375,48375,"Potter County, Texas",Potter County, Texas,10049,3373,1615,1758,6129,1420,631,789,93,61,33,28,43977,10583,4600,5983,6022,1275,687,588,791,119,63,56,2990,792,418,374
2714,1139,87,36,51,0500000US48377,48377,"Presidio County, Texas",Presidio County, Texas,0,0,0,0,860,545,201,344,0,0,0,0,5459,2626,1123,1503,136,0,0,0,161,92,55,37,335,90,54,36
2715,10148,1151,525,626,0500000US48379,48379,"Rains County, Texas",Rains County, Texas,319,5,5,0,156,41,28,13,0,0,0,0,1106,103,42,61,43,0,0,0,162,142,34,108,458,32,0,32
2716,94072,8814,3171,5643,0500000US48381,48381,"Randall County, Texas",Randall County, Texas,3468,758,345,413,6403,352,84,268,257,0,0,0,29605,3141,1257,1884,2628,217,82,135,1116,199,120,79,3685,490,177,313
2717,1011,43,22,21,0500000US48383,48383,"Reagan County, Texas",Reagan County, Texas,34,0,0,0,138,0,0,0,0,0,0,0,2620,360,231,129,41,0,0,0,0,0,0,0,1729,278,182,96
2718,2411,495,170,325,0500000US48385,48385,"Real County, Texas",Real County, Texas,0,0,0,0,24,0,0,0,0,0,0,0,778,323,174,149,2,2,2,0,0,0,0,0,80,69,39,30
2719,8782,1180,531,649,0500000US48387,48387,"Red River County, Texas",Red River County, Texas,1898,645,304,341,259,96,29,67,0,0,0,0,870,468,84,384,11,11,0,11,216,12,12,0,190,129,62,67
2720,3535,452,358,94,0500000US48389,48389,"Reeves County, Texas",Reeves County, Texas,271,3,3,0,802,73,68,5,2,0,0,0,10333,1705,1023,682,148,114,114,0,10,0,0,0,1861,389,316,73
2721,2805,270,94,176,0500000US48391,48391,"Refugio County, Texas",Refugio County, Texas,387,192,64,128,563,101,98,3,0,0,0,0,3515,583,303,280,11,0,0,0,14,0,0,0,378,55,23,32
2722,666,38,11,27,0500000US48393,48393,"Roberts County, Texas",Roberts County, Texas,0,0,0,0,25,0,0,0,0,0,0,0,81,45,22,23,0,0,0,0,1,0,0,0,0,0,0,0
2723,9598,1001,399,602,0500000US48395,48395,"Robertson County, Texas",Robertson County, Texas,3405,1214,542,672,543,68,54,14,18,0,0,0,3579,234,159,75,87,0,0,0,24,0,0,0,337,15,15,0
2724,70222,1770,683,1087,0500000US48397,48397,"Rockwall County, Texas",Rockwall County, Texas,6650,691,216,475,6207,158,50,108,49,0,0,0,18164,1071,415,656,2897,165,71,94,869,0,0,0,3324,129,41,88
2725,6131,525,206,319,0500000US48399,48399,"Runnels County, Texas",Runnels County, Texas,208,51,36,15,838,136,51,85,0,0,0,0,3444,652,205,447,7,0,0,0,5,5,5,0,318,52,32,20
2726,32146,2528,864,1664,0500000US48401,48401,"Rusk County, Texas",Rusk County, Texas,7148,1135,455,680,2360,708,338,370,29,0,0,0,8025,1607,804,803,242,10,0,10,72,19,19,0,847,65,12,53
2727,8734,1566,625,941,0500000US48403,48403,"Sabine County, Texas",Sabine County, Texas,569,142,60,82,283,78,45,33,28,0,0,0,485,155,79,76,24,0,0,0,61,1,1,0,276,78,2,76
2728,5533,1307,703,604,0500000US48405,48405,"San Augustine County, Texas",San Augustine County, Texas,1751,469,195,274,73,0,0,0,0,0,0,0,599,337,174,163,9,0,0,0,44,0,0,0,397,316,157,159
2729,21126,2723,1365,1358,0500000US48407,48407,"San Jacinto County, Texas",San Jacinto County, Texas,2655,304,149,155,1201,540,209,331,12,12,12,0,3842,600,171,429,42,0,0,0,125,0,0,0,327,19,0,19
2730,24980,1472,472,1000,0500000US48409,48409,"San Patricio County, Texas",San Patricio County, Texas,971,318,217,101,4610,684,317,367,71,0,0,0,38492,7965,3288,4677,536,74,41,33,139,64,58,6,1741,507,135,372
2731,3628,405,245,160,0500000US48411,48411,"San Saba County, Texas",San Saba County, Texas,0,0,0,0,251,5,5,0,0,0,0,0,1567,304,99,205,7,0,0,0,0,0,0,0,572,208,59,149
2732,1257,106,19,87,0500000US48413,48413,"Schleicher County, Texas",Schleicher County, Texas,45,5,0,5,41,0,0,0,25,0,0,0,1549,385,198,187,0,0,0,0,1,1,0,1,1030,347,180,167
2733,7836,619,306,313,0500000US48415,48415,"Scurry County, Texas",Scurry County, Texas,388,66,66,0,516,178,134,44,0,0,0,0,6265,1195,728,467,124,0,0,0,4,0,0,0,809,104,30,74
2734,2792,337,121,216,0500000US48417,48417,"Shackelford County, Texas",Shackelford County, Texas,0,0,0,0,88,6,4,2,0,0,0,0,378,27,11,16,12,0,0,0,4,0,0,0,50,0,0,0
2735,15367,2058,888,1170,0500000US48419,48419,"Shelby County, Texas",Shelby County, Texas,4667,1637,614,1023,431,191,85,106,0,0,0,0,4618,2083,1098,985,113,0,0,0,218,0,0,0,551,85,46,39
2736,1602,85,39,46,0500000US48421,48421,"Sherman County, Texas",Sherman County, Texas,14,3,3,0,196,0,0,0,0,0,0,0,1311,247,101,146,35,0,0,0,0,0,0,0,260,3,0,3
2737,133672,13063,5796,7267,0500000US48423,48423,"Smith County, Texas",Smith County, Texas,37692,7094,3542,3552,7280,1578,653,925,185,0,0,0,44758,9487,4402,5085,3761,627,240,387,819,45,21,24,5939,1073,594,479
2738,6965,716,307,409,0500000US48425,48425,"Somervell County, Texas",Somervell County, Texas,84,84,59,25,92,15,15,0,0,0,0,0,1600,600,309,291,57,0,0,0,0,0,0,0,598,294,103,191
2739,558,79,20,59,0500000US48427,48427,"Starr County, Texas",Starr County, Texas,19,1,1,0,7227,3022,1302,1720,0,0,0,0,62806,21590,9594,11996,5,5,3,2,42,0,0,0,3177,603,311,292
2740,6404,1454,533,921,0500000US48429,48429,"Stephens County, Texas",Stephens County, Texas,170,34,0,34,405,25,0,25,0,0,0,0,2147,214,76,138,42,9,0,9,26,26,23,3,101,0,0,0
2741,759,7,0,7,0500000US48431,48431,"Sterling County, Texas",Sterling County, Texas,0,0,0,0,107,0,0,0,0,0,0,0,480,23,23,0,0,0,0,0,0,0,0,0,109,17,17,0
2742,1007,40,13,27,0500000US48433,48433,"Stonewall County, Texas",Stonewall County, Texas,22,13,2,11,31,0,0,0,0,0,0,0,334,73,34,39,0,0,0,0,27,0,0,0,50,0,0,0
2743,1190,16,0,16,0500000US48435,48435,"Sutton County, Texas",Sutton County, Texas,1,1,0,1,95,0,0,0,4,0,0,0,2575,509,253,256,0,0,0,0,15,0,0,0,1528,284,146,138
2744,3218,273,156,117,0500000US48437,48437,"Swisher County, Texas",Swisher County, Texas,385,320,144,176,216,76,3,73,4,0,0,0,3010,1052,440,612,7,1,1,0,163,110,42,68,88,26,0,26
2745,939368,64899,26821,38078,0500000US48439,48439,"Tarrant County, Texas",Tarrant County, Texas,340109,54513,23235,31278,122938,14941,7160,7781,4040,834,431,403,596088,93644,40246,53398,115093,12055,5900,6155,9879,817,410,407,158739,25153,11067,14086
2746,82540,8729,3467,5262,0500000US48441,48441,"Taylor County, Texas",Taylor County, Texas,9552,2512,1123,1389,5921,631,191,440,48,46,23,23,32911,6195,2653,3542,3174,484,256,228,896,280,163,117,12294,2350,1040,1310
2747,403,26,0,26,0500000US48443,48443,"Terrell County, Texas",Terrell County, Texas,14,0,0,0,70,0,0,0,0,0,0,0,454,17,11,6,0,0,0,0,0,0,0,0,75,11,11,0
2748,4820,783,516,267,0500000US48445,48445,"Terry County, Texas",Terry County, Texas,180,63,20,43,584,100,68,32,0,0,0,0,6452,1585,539,1046,2,0,0,0,17,3,0,3,360,18,11,7
2749,1277,237,77,160,0500000US48447,48447,"Throckmorton County, Texas",Throckmorton County, Texas,16,16,0,16,71,58,1,57,0,0,0,0,181,73,22,51,0,0,0,0,0,0,0,0,4,0,0,0
2750,14379,1600,581,1019,0500000US48449,48449,"Titus County, Texas",Titus County, Texas,2963,548,115,433,1954,524,213,311,0,0,0,0,14208,2907,1269,1638,308,25,17,8,92,7,0,7,4260,1096,535,561
2751,59036,6073,2168,3905,0500000US48451,48451,"Tom Green County, Texas",Tom Green County, Texas,4086,782,340,442,8360,873,440,433,20,0,0,0,46552,6666,2861,3805,1136,59,22,37,432,62,27,35,6620,1063,410,653
2752,596086,42929,19666,23263,0500000US48453,48453,"Travis County, Texas",Travis County, Texas,98663,17811,8135,9676,82321,7829,4054,3775,658,189,86,103,413699,65377,29388,35989,83660,11011,5712,5299,7578,1287,727,560,101628,16263,7548,8715
2753,11329,1340,448,892,0500000US48455,48455,"Trinity County, Texas",Trinity County, Texas,1247,514,350,164,481,307,229,78,0,0,0,0,1519,450,247,203,10,0,0,0,23,0,0,0,349,59,5,54
2754,16209,2704,1134,1570,0500000US48457,48457,"Tyler County, Texas",Tyler County, Texas,1034,497,303,194,599,207,81,126,0,0,0,0,1016,102,22,80,75,22,18,4,19,0,0,0,351,17,1,16
2755,32718,4349,2074,2275,0500000US48459,48459,"Upshur County, Texas",Upshur County, Texas,3273,766,319,447,1449,127,62,65,0,0,0,0,3547,742,206,536,159,71,45,26,149,42,42,0,1038,181,63,118
2756,1433,123,95,28,0500000US48461,48461,"Upton County, Texas",Upton County, Texas,245,0,0,0,52,0,0,0,0,0,0,0,1953,276,117,159,26,0,0,0,14,0,0,0,1600,273,114,159
2757,6731,778,253,525,0500000US48463,48463,"Uvalde County, Texas",Uvalde County, Texas,118,26,26,0,1148,331,246,85,25,25,0,25,19008,4678,2164,2514,213,0,0,0,121,44,44,0,1233,538,244,294
2758,6583,904,412,492,0500000US48465,48465,"Val Verde County, Texas",Val Verde County, Texas,518,96,96,0,3800,506,213,293,5,0,0,0,39145,7611,3735,3876,346,0,0,0,155,64,25,39,2631,342,105,237
2759,45983,5058,2224,2834,0500000US48467,48467,"Van Zandt County, Texas",Van Zandt County, Texas,1461,421,104,317,1304,423,105,318,6,0,0,0,6184,1259,532,727,206,0,0,0,417,115,34,81,670,154,73,81
2760,39975,3802,1319,2483,0500000US48469,48469,"Victoria County, Texas",Victoria County, Texas,5251,1348,733,615,6641,951,684,267,93,0,0,0,42828,8934,4067,4867,1077,39,39,0,323,9,2,7,2748,241,117,124
2761,33447,4822,2162,2660,0500000US48471,48471,"Walker County, Texas",Walker County, Texas,12028,3610,1226,2384,1734,445,147,298,182,16,0,16,8293,2539,867,1672,804,521,188,333,121,0,0,0,517,109,17,92
2762,22786,1654,857,797,0500000US48473,48473,"Waller County, Texas",Waller County, Texas,9498,3051,1584,1467,1775,139,16,123,0,0,0,0,16011,2432,958,1474,638,68,53,15,373,3,1,2,8247,1545,492,1053
2763,4565,308,73,235,0500000US48475,48475,"Ward County, Texas",Ward County, Texas,559,39,1,38,340,3,0,3,0,0,0,0,6334,998,379,619,64,0,0,0,171,6,0,6,553,76,19,57
2764,21375,1184,502,682,0500000US48477,48477,"Washington County, Texas",Washington County, Texas,5388,1336,817,519,1047,65,0,65,0,0,0,0,5381,738,317,421,556,198,84,114,60,0,0,0,359,64,48,16
2765,9398,1311,388,923,0500000US48479,48479,"Webb County, Texas",Webb County, Texas,1195,171,92,79,39912,7858,3133,4725,21,0,0,0,259634,64996,29170,35826,1359,367,80,287,470,83,43,40,8213,1653,904,749
2766,18160,1327,618,709,0500000US48481,48481,"Wharton County, Texas",Wharton County, Texas,5400,1444,657,787,2415,255,126,129,0,0,0,0,17203,3451,1475,1976,141,22,22,0,36,0,0,0,1929,334,129,205
2767,3515,374,146,228,0500000US48483,48483,"Wheeler County, Texas",Wheeler County, Texas,140,22,2,20,196,65,39,26,0,0,0,0,1336,454,200,254,17,0,0,0,16,1,1,0,142,20,17,3
2768,78814,11130,4715,6415,0500000US48485,48485,"Wichita County, Texas",Wichita County, Texas,10354,3488,1501,1987,6170,1225,439,786,144,4,4,0,22308,4970,2113,2857,2455,353,154,199,1106,267,158,109,4475,878,427,451
2769,6918,1119,517,602,0500000US48487,48487,"Wilbarger County, Texas",Wilbarger County, Texas,1179,360,153,207,984,180,143,37,0,0,0,0,3671,819,441,378,126,1,0,1,180,47,21,26,748,172,102,70
2770,2143,356,210,146,0500000US48489,48489,"Willacy County, Texas",Willacy County, Texas,31,31,29,2,2162,599,292,307,0,0,0,0,17863,4794,2342,2452,0,0,0,0,94,0,0,0,312,52,26,26
2771,330307,15087,6681,8406,0500000US48491,48491,"Williamson County, Texas",Williamson County, Texas,35962,4170,1653,2517,41231,2681,1201,1480,708,230,0,230,138723,11952,5469,6483,40468,1665,848,817,1883,220,58,162,17102,789,556,233
2772,27700,1716,753,963,0500000US48493,48493,"Wilson County, Texas",Wilson County, Texas,580,123,85,38,3299,417,203,214,30,0,0,0,19848,2882,1285,1597,253,103,50,53,188,0,0,0,1260,168,83,85
2773,2586,306,122,184,0500000US48495,48495,"Winkler County, Texas",Winkler County, Texas,271,0,0,0,893,78,40,38,2,2,0,2,4778,533,352,181,0,0,0,0,132,0,0,0,206,122,52,70
2774,51257,4698,2170,2528,0500000US48497,48497,"Wise County, Texas",Wise County, Texas,732,26,12,14,1840,133,63,70,140,22,0,22,12928,2128,1013,1115,276,3,0,3,434,2,0,2,1744,45,7,38
2775,36243,3981,1575,2406,0500000US48499,48499,"Wood County, Texas",Wood County, Texas,1693,415,226,189,926,222,182,40,41,0,0,0,4299,980,528,452,219,8,0,8,408,0,0,0,1125,314,140,174
2776,2706,159,90,69,0500000US48501,48501,"Yoakum County, Texas",Yoakum County, Texas,13,0,0,0,771,205,34,171,0,0,0,0,5766,799,405,394,27,0,0,0,108,0,0,0,402,276,160,116
2777,13726,1679,628,1051,0500000US48503,48503,"Young County, Texas",Young County, Texas,275,34,0,34,257,15,13,2,0,0,0,0,3340,711,318,393,44,25,12,13,178,0,0,0,241,106,66,40
2778,559,173,56,117,0500000US48505,48505,"Zapata County, Texas",Zapata County, Texas,0,0,0,0,1865,555,316,239,0,0,0,0,13288,4351,1858,2493,171,0,0,0,0,0,0,0,709,268,142,126
2779,585,250,191,59,0500000US48507,48507,"Zavala County, Texas",Zavala County, Texas,72,72,61,11,1379,281,237,44,0,0,0,0,11123,3808,1861,1947,36,0,0,0,0,0,0,0,326,70,0,70
2780,5529,173,85,88,0500000US49001,49001,"Beaver County, Utah",Beaver County, Utah,0,0,0,0,163,15,8,7,0,0,0,0,781,98,49,49,20,0,0,0,63,0,0,0,235,71,36,35
2781,47379,3589,1720,1869,0500000US49003,49003,"Box Elder County, Utah",Box Elder County, Utah,270,0,0,0,1602,88,29,59,87,0,0,0,5157,682,236,446,453,50,40,10,489,10,2,8,1118,149,86,63
2782,103274,12961,6221,6740,0500000US49005,49005,"Cache County, Utah",Cache County, Utah,851,437,287,150,4061,1072,486,586,497,116,25,91,13127,2788,1310,1478,2369,847,427,420,410,82,34,48,3991,408,148,260
2783,16640,2405,1084,1321,0500000US49007,49007,"Carbon County, Utah",Carbon County, Utah,248,57,0,57,704,75,39,36,97,0,0,0,2679,700,274,426,0,0,0,0,313,73,0,73,437,45,16,29
2784,513,17,10,7,0500000US49009,49009,"Daggett County, Utah",Daggett County, Utah,0,0,0,0,0,0,0,0,0,0,0,0,3,0,0,0,0,0,0,0,2,0,0,0,0,0,0,0
2785,290119,13128,5032,8096,0500000US49011,49011,"Davis County, Utah",Davis County, Utah,4327,612,305,307,16333,657,305,352,2585,266,162,104,34284,3574,1689,1885,6009,519,170,349,1531,169,40,129,6623,1041,512,529
2786,16640,1880,825,1055,0500000US49013,49013,"Duchesne County, Utah",Duchesne County, Utah,30,14,14,0,457,61,27,34,69,0,0,0,1633,405,229,176,66,0,0,0,847,401,171,230,666,131,75,56
2787,9076,983,422,561,0500000US49015,49015,"Emery County, Utah",Emery County, Utah,7,4,4,0,78,0,0,0,27,0,0,0,631,213,129,84,104,0,0,0,68,0,0,0,0,0,0,0
2788,4318,640,386,254,0500000US49017,49017,"Garfield County, Utah",Garfield County, Utah,0,0,0,0,18,0,0,0,6,0,0,0,246,79,6,73,2,0,0,0,213,69,10,59,58,0,0,0
2789,7840,841,355,486,0500000US49019,49019,"Grand County, Utah",Grand County, Utah,41,0,0,0,269,214,106,108,41,0,0,0,990,219,182,37,183,0,0,0,202,70,0,70,10,0,0,0
2790,45024,7359,3270,4089,0500000US49021,49021,"Iron County, Utah",Iron County, Utah,315,136,111,25,1684,85,21,64,133,23,23,0,4707,654,296,358,479,127,0,127,978,220,74,146,1233,247,136,111
2791,10524,999,358,641,0500000US49023,49023,"Juab County, Utah",Juab County, Utah,44,21,21,0,275,102,19,83,21,20,18,2,606,220,39,181,16,0,0,0,158,18,13,5,252,159,35,124
2792,6819,830,388,442,0500000US49025,49025,"Kane County, Utah",Kane County, Utah,14,14,0,14,39,8,3,5,12,0,0,0,335,102,6,96,124,124,42,82,252,0,0,0,72,0,0,0
2793,10655,860,337,523,0500000US49027,49027,"Millard County, Utah",Millard County, Utah,33,5,0,5,332,55,8,47,6,0,0,0,1634,606,365,241,163,28,21,7,145,38,8,30,822,230,147,83
2794,11232,166,95,71,0500000US49029,49029,"Morgan County, Utah",Morgan County, Utah,95,0,0,0,247,0,0,0,29,0,0,0,338,35,16,19,24,0,0,0,16,0,0,0,162,10,0,10
2795,1766,338,202,136,0500000US49031,49031,"Piute County, Utah",Piute County, Utah,0,0,0,0,9,9,5,4,0,0,0,0,56,0,0,0,0,0,0,0,4,4,0,4,47,0,0,0
2796,2155,98,43,55,0500000US49033,49033,"Rich County, Utah",Rich County, Utah,0,0,0,0,47,0,0,0,0,0,0,0,229,154,12,142,0,0,0,0,0,0,0,0,162,154,12,142
2797,799272,49630,23535,26095,0500000US49035,49035,"Salt Lake County, Utah",Salt Lake County, Utah,21755,5406,2513,2893,53037,5204,2680,2524,17729,1168,536,632,208054,30980,13877,17103,46211,5647,2516,3131,8795,1678,530,1148,104349,18142,7891,10251
2798,6629,612,207,405,0500000US49037,49037,"San Juan County, Utah",San Juan County, Utah,17,0,0,0,516,247,114,133,43,16,4,12,765,297,108,189,88,17,0,17,6931,2234,1211,1023,49,5,5,0
2799,24383,3279,1181,2098,0500000US49039,49039,"Sanpete County, Utah",Sanpete County, Utah,79,25,25,0,404,41,26,15,153,62,39,23,2123,621,266,355,126,0,0,0,244,27,0,27,1677,590,257,333
2800,19390,2711,1199,1512,0500000US49041,49041,"Sevier County, Utah",Sevier County, Utah,132,0,0,0,262,35,24,11,59,0,0,0,1065,169,48,121,64,0,0,0,247,102,95,7,399,52,24,28
2801,35054,1407,661,746,0500000US49043,49043,"Summit County, Utah",Summit County, Utah,262,18,10,8,1546,69,13,56,2,0,0,0,4617,418,116,302,713,14,0,14,162,0,0,0,795,57,11,46
2802,56571,2843,1341,1502,0500000US49045,49045,"Tooele County, Utah",Tooele County, Utah,435,0,0,0,3431,203,84,119,457,26,17,9,8736,823,414,409,424,31,31,0,367,162,61,101,2790,511,264,247
2803,28638,2921,1381,1540,0500000US49047,49047,"Uintah County, Utah",Uintah County, Utah,144,106,34,72,1289,128,14,114,27,0,0,0,2950,732,396,336,268,70,0,70,2475,804,439,365,437,76,5,71
2804,497019,44016,19706,24310,0500000US49049,49049,"Utah County, Utah",Utah County, Utah,3574,869,488,381,26644,2803,1425,1378,5074,1041,596,445,72506,10789,5237,5552,8469,1961,1145,816,3301,665,243,422,12590,2316,1071,1245
2805,27427,858,451,407,0500000US49051,49051,"Wasatch County, Utah",Wasatch County, Utah,215,3,3,0,1421,150,2,148,0,0,0,0,4467,614,221,393,342,10,10,0,112,59,59,0,640,22,10,12
2806,143143,12018,5374,6644,0500000US49053,49053,"Washington County, Utah",Washington County, Utah,1148,183,134,49,4584,486,199,287,1184,231,94,137,17962,2970,1568,1402,1552,443,93,350,2271,947,403,544,6254,1002,445,557
2807,2444,269,87,182,0500000US49055,49055,"Wayne County, Utah",Wayne County, Utah,2,0,0,0,20,1,0,1,22,0,0,0,159,0,0,0,4,0,0,0,17,0,0,0,2,0,0,0
2808,191647,13424,5771,7653,0500000US49057,49057,"Weber County, Utah",Weber County, Utah,2415,417,230,187,11777,1213,702,511,660,99,99,0,46296,6619,3311,3308,3172,222,91,131,1658,298,177,121,10927,1309,754,555
2809,31957,2145,1067,1078,0500000US50001,50001,"Addison County, Vermont",Addison County, Vermont,333,58,28,30,706,89,58,31,8,8,0,8,574,132,86,46,352,1,0,1,108,42,16,26,110,9,0,9
2810,32302,3518,1592,1926,0500000US50003,50003,"Bennington County, Vermont",Bennington County, Vermont,241,56,45,11,728,109,101,8,46,0,0,0,690,204,120,84,273,32,0,32,138,0,0,0,122,23,23,0
2811,27438,3186,1470,1716,0500000US50005,50005,"Caledonia County, Vermont",Caledonia County, Vermont,183,20,9,11,775,121,48,73,0,0,0,0,482,169,135,34,141,54,46,8,50,24,0,24,214,50,38,12
2812,135218,14041,6030,8011,0500000US50007,50007,"Chittenden County, Vermont",Chittenden County, Vermont,4168,1096,628,468,5339,909,430,479,56,0,0,0,3634,473,155,318,5889,850,428,422,258,45,17,28,855,53,31,22
2813,5854,801,243,558,0500000US50009,50009,"Essex County, Vermont",Essex County, Vermont,46,46,30,16,147,4,0,4,0,0,0,0,86,13,6,7,27,6,0,6,4,0,0,0,17,13,6,7
2814,45771,4203,1711,2492,0500000US50011,50011,"Franklin County, Vermont",Franklin County, Vermont,167,5,0,5,1534,501,178,323,0,0,0,0,811,36,18,18,363,2,2,0,318,40,21,19,307,3,3,0
2815,6506,440,206,234,0500000US50013,50013,"Grand Isle County, Vermont",Grand Isle County, Vermont,63,1,1,0,226,5,0,5,0,0,0,0,144,0,0,0,38,0,0,0,108,0,0,0,7,1,1,0
2816,23358,2691,1353,1338,0500000US50015,50015,"Lamoille County, Vermont",Lamoille County, Vermont,251,143,143,0,638,151,25,126,0,0,0,0,429,93,50,43,66,0,0,0,145,48,48,0,99,1,1,0
2817,26984,2632,1254,1378,0500000US50017,50017,"Orange County, Vermont",Orange County, Vermont,115,0,0,0,664,53,4,49,24,0,0,0,369,71,3,68,95,7,0,7,88,10,1,9,77,1,0,1
2818,24616,3018,1231,1787,0500000US50019,50019,"Orleans County, Vermont",Orleans County, Vermont,154,11,2,9,590,66,33,33,7,0,0,0,368,72,6,66,50,2,0,2,134,12,0,12,69,1,0,1
2819,53707,5608,2471,3137,0500000US50021,50021,"Rutland County, Vermont",Rutland County, Vermont,246,31,12,19,1251,342,131,211,0,0,0,0,828,131,29,102,452,36,0,36,177,3,0,3,62,6,0,6
2820,52755,5110,2382,2728,0500000US50023,50023,"Washington County, Vermont",Washington County, Vermont,434,100,100,0,1342,196,146,50,42,9,0,9,855,167,54,113,526,142,15,127,79,41,0,41,179,33,3,30
2821,38135,4885,2063,2822,0500000US50025,50025,"Windham County, Vermont",Windham County, Vermont,379,136,78,58,1171,216,120,96,12,0,0,0,875,69,27,42,458,171,99,72,105,49,18,31,70,2,2,0
2822,51425,4789,2282,2507,0500000US50027,50027,"Windsor County, Vermont",Windsor County, Vermont,350,26,16,10,1144,103,39,64,0,0,0,0,959,155,56,99,539,32,21,11,93,21,14,7,237,9,9,0
2823,19330,2079,875,1204,0500000US51001,51001,"Accomack County, Virginia",Accomack County, Virginia,9271,2865,1461,1404,950,143,60,83,0,0,0,0,2847,1221,656,565,244,71,46,25,48,6,6,0,149,0,0,0
2824,79023,5123,2214,2909,0500000US51003,51003,"Albemarle County, Virginia",Albemarle County, Virginia,8937,1213,491,722,3159,294,152,142,48,0,0,0,5811,618,253,365,4623,485,273,212,296,29,1,28,969,34,20,14
2825,13497,1937,787,1150,0500000US51005,51005,"Alleghany County, Virginia",Alleghany County, Virginia,751,220,93,127,235,138,85,53,0,0,0,0,231,20,0,20,5,0,0,0,0,0,0,0,64,0,0,0
2826,9384,641,313,328,0500000US51007,51007,"Amelia County, Virginia",Amelia County, Virginia,2858,463,192,271,304,0,0,0,0,0,0,0,408,278,190,88,1,0,0,0,0,0,0,0,0,0,0,0
2827,23221,2067,983,1084,0500000US51009,51009,"Amherst County, Virginia",Amherst County, Virginia,5575,814,458,356,1027,270,157,113,12,0,0,0,724,154,79,75,203,38,8,30,243,55,0,55,201,0,0,0
2828,12081,1048,403,645,0500000US51011,51011,"Appomattox County, Virginia",Appomattox County, Virginia,2990,836,256,580,322,163,85,78,0,0,0,0,286,33,11,22,21,15,9,6,6,0,0,0,57,32,17,15
2829,142148,5216,2390,2826,0500000US51013,51013,"Arlington County, Virginia",Arlington County, Virginia,20949,2512,1013,1499,13639,955,536,419,269,0,0,0,35978,3744,1461,2283,24296,2972,1131,1841,818,122,45,77,11869,1734,792,942
2830,66190,5332,1831,3501,0500000US51015,51015,"Augusta County, Virginia",Augusta County, Virginia,1521,300,109,191,1413,85,49,36,87,43,0,43,1993,501,179,322,400,48,26,22,74,3,3,0,577,378,188,190
2831,3834,554,360,194,0500000US51017,51017,"Bath County, Virginia",Bath County, Virginia,198,164,77,87,89,49,38,11,0,0,0,0,29,14,14,0,16,0,0,0,8,0,0,0,15,0,0,0
2832,68373,4969,2117,2852,0500000US51019,51019,"Bedford County, Virginia",Bedford County, Virginia,5081,945,423,522,2128,126,58,68,17,0,0,0,1844,210,96,114,984,108,11,97,43,0,0,0,519,151,81,70
2833,5234,605,312,293,0500000US51021,51021,"Bland County, Virginia",Bland County, Virginia,10,0,0,0,61,0,0,0,0,0,0,0,33,0,0,0,8,0,0,0,0,0,0,0,0,0,0,0
2834,30756,1955,792,1163,0500000US51023,51023,"Botetourt County, Virginia",Botetourt County, Virginia,857,80,30,50,678,13,0,13,0,0,0,0,593,13,10,3,219,3,2,1,41,0,0,0,136,0,0,0
2835,5846,675,226,449,0500000US51025,51025,"Brunswick County, Virginia",Brunswick County, Virginia,7342,1892,663,1229,401,99,65,34,0,0,0,0,308,25,25,0,7,3,3,0,9,9,0,9,204,25,25,0
2836,19781,4932,2571,2361,0500000US51027,51027,"Buchanan County, Virginia",Buchanan County, Virginia,166,137,110,27,135,0,0,0,0,0,0,0,129,25,25,0,39,0,0,0,166,0,0,0,147,25,25,0
2837,9530,1230,485,745,0500000US51029,51029,"Buckingham County, Virginia",Buckingham County, Virginia,4448,791,404,387,450,2,2,0,0,0,0,0,305,260,86,174,7,0,0,0,132,114,53,61,272,263,45,218
2838,43296,4029,1772,2257,0500000US51031,51031,"Campbell County, Virginia",Campbell County, Virginia,7649,1150,331,819,1879,230,187,43,10,0,0,0,1491,125,7,118,524,126,48,78,99,9,2,7,273,95,47,48
2839,18065,1079,317,762,0500000US51033,51033,"Caroline County, Virginia",Caroline County, Virginia,7567,747,430,317,1189,290,103,187,0,0,0,0,1215,140,55,85,52,0,0,0,100,65,21,44,853,41,41,0
2840,27942,3919,2059,1860,0500000US51035,51035,"Carroll County, Virginia",Carroll County, Virginia,179,87,79,8,441,171,110,61,0,0,0,0,1111,505,340,165,0,0,0,0,119,90,90,0,108,63,15,48
2841,2977,399,182,217,0500000US51036,51036,"Charles City County, Virginia",Charles City County, Virginia,3052,405,175,230,325,37,16,21,0,0,0,0,135,0,0,0,70,16,3,13,419,28,12,16,15,0,0,0
2842,7983,1804,806,998,0500000US51037,51037,"Charlotte County, Virginia",Charlotte County, Virginia,3190,731,395,336,161,46,39,7,0,0,0,0,264,229,117,112,43,0,0,0,30,0,0,0,22,7,0,7
2843,211056,9362,3908,5454,0500000US51041,51041,"Chesterfield County, Virginia",Chesterfield County, Virginia,77804,7017,2955,4062,13434,978,376,602,128,0,0,0,31487,4692,2052,2640,11888,698,402,296,840,61,32,29,13209,2091,902,1189
2844,12234,635,278,357,0500000US51043,51043,"Clarke County, Virginia",Clarke County, Virginia,636,69,46,23,351,140,26,114,0,0,0,0,813,1,1,0,223,16,8,8,0,0,0,0,256,0,0,0
2845,5008,606,244,362,0500000US51045,51045,"Craig County, Virginia",Craig County, Virginia,0,0,0,0,88,0,0,0,0,0,0,0,0,0,0,0,0,0,0,0,0,0,0,0,0,0,0,0
2846,35194,2272,875,1397,0500000US51047,51047,"Culpeper County, Virginia",Culpeper County, Virginia,6509,576,312,264,2418,246,99,147,67,0,0,0,5426,791,281,510,846,45,0,45,239,18,0,18,2440,317,69,248
2847,6256,543,189,354,0500000US51049,51049,"Cumberland County, Virginia",Cumberland County, Virginia,3243,420,215,205,181,74,63,11,0,0,0,0,105,0,0,0,102,0,0,0,9,0,0,0,65,0,0,0
2848,13762,3151,1325,1826,0500000US51051,51051,"Dickenson County, Virginia",Dickenson County, Virginia,12,2,0,2,172,58,5,53,0,0,0,0,120,90,20,70,16,16,0,16,5,5,0,5,9,0,0,0
2849,17481,1558,513,1045,0500000US51053,51053,"Dinwiddie County, Virginia",Dinwiddie County, Virginia,8782,1175,464,711,304,85,29,56,27,0,0,0,1014,273,211,62,215,18,0,18,6,6,0,6,236,0,0,0
2850,5936,764,334,430,0500000US51057,51057,"Essex County, Virginia",Essex County, Virginia,4241,789,246,543,211,29,10,19,0,0,0,0,416,0,0,0,63,52,38,14,0,0,0,0,173,0,0,0
2851,569989,22532,10614,11918,0500000US51059,51059,"Fairfax County, Virginia",Fairfax County, Virginia,108990,11682,5429,6253,69131,3760,1524,2236,991,249,161,88,184909,17433,7095,10338,227348,12979,6147,6832,3193,254,54,200,56706,6728,2847,3881
2852,55680,2081,710,1371,0500000US51061,51061,"Fauquier County, Virginia",Fauquier County, Virginia,5068,296,152,144,2864,287,112,175,25,0,0,0,6022,1331,642,689,1262,48,35,13,303,23,23,0,405,54,20,34
2853,14611,1458,713,745,0500000US51063,51063,"Floyd County, Virginia",Floyd County, Virginia,247,1,0,1,338,0,0,0,0,0,0,0,457,92,81,11,46,4,0,4,124,23,0,23,97,97,90,7
2854,19811,603,236,367,0500000US51065,51065,"Fluvanna County, Virginia",Fluvanna County, Virginia,3482,285,190,95,937,113,48,65,26,0,0,0,904,121,53,68,368,115,72,43,18,0,0,0,244,83,53,30
2855,47994,6061,2980,3081,0500000US51067,51067,"Franklin County, Virginia",Franklin County, Virginia,3823,854,394,460,1151,460,126,334,0,0,0,0,1452,414,80,334,335,0,0,0,139,0,0,0,248,139,29,110
2856,71787,3333,1409,1924,0500000US51069,51069,"Frederick County, Virginia",Frederick County, Virginia,2967,265,129,136,3435,315,176,139,38,0,0,0,7831,1250,494,756,1340,151,31,120,144,0,0,0,732,64,17,47
2857,15719,1434,691,743,0500000US51071,51071,"Giles County, Virginia",Giles County, Virginia,268,3,1,2,268,29,12,17,29,0,0,0,301,93,38,55,79,79,0,79,0,0,0,0,0,0,0,0
2858,31008,2241,812,1429,0500000US51073,51073,"Gloucester County, Virginia",Gloucester County, Virginia,3632,519,150,369,557,114,24,90,0,0,0,0,1379,23,0,23,290,17,17,0,19,0,0,0,125,0,0,0
2859,17633,586,192,394,0500000US51075,51075,"Goochland County, Virginia",Goochland County, Virginia,2925,275,72,203,716,16,2,14,0,0,0,0,650,63,0,63,362,34,0,34,0,0,0,0,250,0,0,0
2860,13583,2207,968,1239,0500000US51077,51077,"Grayson County, Virginia",Grayson County, Virginia,320,122,75,47,90,26,0,26,0,0,0,0,477,38,21,17,157,3,0,3,0,0,0,0,68,10,10,0
2861,15900,999,330,669,0500000US51079,51079,"Greene County, Virginia",Greene County, Virginia,1498,202,127,75,604,161,8,153,0,0,0,0,1176,341,121,220,407,27,0,27,42,0,0,0,791,507,228,279
2862,3183,135,56,79,0500000US51081,51081,"Greensville County, Virginia",Greensville County, Virginia,4608,949,351,598,206,18,18,0,0,0,0,0,104,6,0,6,0,0,0,0,0,0,0,0,0,0,0,0
2863,20150,2259,1123,1136,0500000US51083,51083,"Halifax County, Virginia",Halifax County, Virginia,11410,2450,674,1776,1066,338,226,112,0,0,0,0,721,132,102,30,253,30,0,30,85,0,0,0,40,0,0,0
2864,87593,3908,1891,2017,0500000US51085,51085,"Hanover County, Virginia",Hanover County, Virginia,9202,682,286,396,2915,161,11,150,180,0,0,0,3189,127,86,41,1692,72,19,53,319,66,26,40,1040,70,22,48
2865,171311,10317,4618,5699,0500000US51087,51087,"Henrico County, Virginia",Henrico County, Virginia,96464,11868,4598,7270,12588,1002,529,473,89,16,11,5,18993,3757,1628,2129,29770,1994,921,1073,556,2,0,2,7014,2213,940,1273
2866,35067,4835,1980,2855,0500000US51089,51089,"Henry County, Virginia",Henry County, Virginia,11170,1930,851,1079,1264,70,37,33,0,0,0,0,2843,952,432,520,316,70,0,70,28,28,18,10,1103,676,286,390
2867,2095,190,82,108,0500000US51091,51091,"Highland County, Virginia",Highland County, Virginia,0,0,0,0,10,0,0,0,0,0,0,0,0,0,0,0,80,33,33,0,0,0,0,0,0,0,0,0
2868,25846,1402,539,863,0500000US51093,51093,"Isle of Wight County, Virginia",Isle of Wight County, Virginia,8394,1544,535,1009,1139,97,64,33,9,0,0,0,1292,509,216,293,346,27,15,12,62,0,0,0,416,224,75,149
2869,56373,2647,1490,1157,0500000US51095,51095,"James City County, Virginia",James City County, Virginia,9336,1188,519,669,3398,259,115,144,12,0,0,0,4453,593,310,283,2153,304,112,192,26,0,0,0,711,0,0,0
2870,4612,191,65,126,0500000US51097,51097,"King and Queen County, Virginia",King and Queen County, Virginia,1984,502,342,160,212,93,32,61,0,0,0,0,235,124,113,11,0,0,0,0,7,0,0,0,124,124,113,11
2871,19142,1047,365,682,0500000US51099,51099,"King George County, Virginia",King George County, Virginia,4364,208,86,122,1226,36,2,34,0,0,0,0,1460,71,15,56,273,9,9,0,37,19,0,19,180,17,0,17
2872,13007,675,288,387,0500000US51101,51101,"King William County, Virginia",King William County, Virginia,2548,365,173,192,676,63,11,52,0,0,0,0,458,66,28,38,237,39,19,20,122,10,4,6,16,0,0,0
2873,7069,620,237,383,0500000US51103,51103,"Lancaster County, Virginia",Lancaster County, Virginia,2969,614,116,498,328,302,0,302,0,0,0,0,94,34,34,0,111,0,0,0,0,0,0,0,26,0,0,0
2874,21680,5934,2748,3186,0500000US51105,51105,"Lee County, Virginia",Lee County, Virginia,125,41,29,12,216,81,59,22,0,0,0,0,81,13,13,0,60,12,0,12,37,5,0,5,13,0,0,0
2875,222342,6015,2396,3619,0500000US51107,51107,"Loudoun County, Virginia",Loudoun County, Virginia,30829,1710,728,982,26118,955,288,667,508,8,6,2,54589,3287,972,2315,77800,1470,587,883,1149,69,48,21,14967,1538,544,994
2876,28370,2362,884,1478,0500000US51109,51109,"Louisa County, Virginia",Louisa County, Virginia,5164,1226,511,715,1649,297,131,166,0,0,0,0,1136,251,72,179,196,0,0,0,48,0,0,0,386,219,50,169
2877,6896,660,372,288,0500000US51111,51111,"Lunenburg County, Virginia",Lunenburg County, Virginia,3620,1006,398,608,201,10,0,10,0,0,0,0,565,8,1,7,61,0,0,0,2,1,0,1,313,7,0,7
2878,11084,948,359,589,0500000US51113,51113,"Madison County, Virginia",Madison County, Virginia,1119,100,59,41,352,46,45,1,0,0,0,0,389,189,109,80,129,0,0,0,0,0,0,0,109,79,0,79
2879,7422,420,300,120,0500000US51115,51115,"Mathews County, Virginia",Mathews County, Virginia,698,286,88,198,288,27,24,3,0,0,0,0,239,0,0,0,42,0,0,0,0,0,0,0,0,0,0,0
2880,18137,1990,738,1252,0500000US51117,51117,"Mecklenburg County, Virginia",Mecklenburg County, Virginia,9901,2645,1250,1395,401,102,51,51,4,0,0,0,852,290,115,175,289,8,4,4,157,0,0,0,144,0,0,0
2881,7970,591,182,409,0500000US51119,51119,"Middlesex County, Virginia",Middlesex County, Virginia,1526,186,69,117,274,66,0,66,18,0,0,0,162,39,14,25,72,68,47,21,37,10,0,10,253,31,0,31
2882,74631,16123,8110,8013,0500000US51121,51121,"Montgomery County, Virginia",Montgomery County, Virginia,3533,1084,523,561,2032,440,178,262,43,26,11,15,2738,971,503,468,5917,2051,1285,766,353,89,32,57,1010,587,395,192
2883,11943,1176,547,629,0500000US51125,51125,"Nelson County, Virginia",Nelson County, Virginia,1932,420,116,304,126,0,0,0,0,0,0,0,645,77,21,56,45,14,0,14,0,0,0,0,156,21,21,0
2884,17147,808,258,550,0500000US51127,51127,"New Kent County, Virginia",New Kent County, Virginia,2582,181,14,167,724,36,18,18,0,0,0,0,760,0,0,0,254,14,0,14,227,0,0,0,196,0,0,0
2885,6323,457,259,198,0500000US51131,51131,"Northampton County, Virginia",Northampton County, Virginia,3804,1006,418,588,378,177,80,97,0,0,0,0,1016,289,166,123,133,0,0,0,2,0,0,0,80,4,1,3
2886,8374,742,386,356,0500000US51133,51133,"Northumberland County, Virginia",Northumberland County, Virginia,3208,727,338,389,333,105,66,39,0,0,0,0,171,91,22,69,17,0,0,0,0,0,0,0,0,0,0,0
2887,7615,737,270,467,0500000US51135,51135,"Nottoway County, Virginia",Nottoway County, Virginia,5301,1458,775,683,91,40,24,16,0,0,0,0,551,72,36,36,40,26,26,0,0,0,0,0,170,0,0,0
2888,27876,2249,1061,1188,0500000US51137,51137,"Orange County, Virginia",Orange County, Virginia,4604,1366,609,757,1548,181,98,83,0,0,0,0,1901,124,40,84,534,9,9,0,89,0,0,0,429,4,4,0
2889,22152,3029,1474,1555,0500000US51139,51139,"Page County, Virginia",Page County, Virginia,211,0,0,0,696,6,5,1,0,0,0,0,494,79,23,56,130,43,0,43,30,0,0,0,106,25,23,2
2890,15451,1987,956,1031,0500000US51141,51141,"Patrick County, Virginia",Patrick County, Virginia,909,103,36,67,196,50,35,15,0,0,0,0,529,62,18,44,76,0,0,0,27,5,0,5,209,54,14,40
2891,44321,5539,2187,3352,0500000US51143,51143,"Pittsylvania County, Virginia",Pittsylvania County, Virginia,11713,2589,1089,1500,1843,543,333,210,0,0,0,0,1539,315,145,170,262,57,24,33,26,6,0,6,616,50,38,12
2892,23876,999,405,594,0500000US51145,51145,"Powhatan County, Virginia",Powhatan County, Virginia,1563,212,47,165,821,7,2,5,20,0,0,0,492,62,39,23,12,0,0,0,7,0,0,0,120,0,0,0
2893,10213,1676,669,1007,0500000US51147,51147,"Prince Edward County, Virginia",Prince Edward County, Virginia,6176,2103,748,1355,655,176,71,105,0,0,0,0,137,39,24,15,53,0,0,0,65,16,0,16,37,37,22,15
2894,19002,1089,496,593,0500000US51149,51149,"Prince George County, Virginia",Prince George County, Virginia,10312,923,292,631,1978,157,128,29,142,0,0,0,2715,207,89,118,570,66,62,4,103,0,0,0,598,158,95,63
2895,192406,5878,2684,3194,0500000US51153,51153,"Prince William County, Virginia",Prince William County, Virginia,96503,5683,2389,3294,31602,1780,693,1087,335,0,0,0,109752,12519,5359,7160,43860,2443,996,1447,1673,49,31,18,34885,5428,2569,2859
2896,30024,3408,1533,1875,0500000US51155,51155,"Pulaski County, Virginia",Pulaski County, Virginia,1240,337,238,99,638,314,190,124,80,0,0,0,601,346,179,167,253,34,9,25,7,0,0,0,156,75,57,18
2897,6454,415,135,280,0500000US51157,51157,"Rappahannock County, Virginia",Rappahannock County, Virginia,334,58,0,58,240,73,17,56,0,0,0,0,289,85,29,56,18,8,8,0,38,0,0,0,191,0,0,0
2898,4807,473,224,249,0500000US51159,51159,"Richmond County, Virginia",Richmond County, Virginia,1548,470,163,307,383,269,146,123,0,0,0,0,529,9,8,1,4,0,0,0,14,0,0,0,296,1,0,1
2899,78618,4963,2246,2717,0500000US51161,51161,"Roanoke County, Virginia",Roanoke County, Virginia,5199,397,108,289,2161,335,152,183,22,0,0,0,2924,303,109,194,3165,82,27,55,182,0,0,0,681,7,0,7
2900,20682,2532,1510,1022,0500000US51163,51163,"Rockbridge County, Virginia",Rockbridge County, Virginia,606,43,18,25,497,39,16,23,0,0,0,0,456,194,65,129,239,0,0,0,88,6,6,0,74,0,0,0
2901,70024,5054,2203,2851,0500000US51165,51165,"Rockingham County, Virginia",Rockingham County, Virginia,2002,228,78,150,2099,491,320,171,63,9,0,9,5731,881,427,454,547,77,48,29,63,0,0,0,680,73,19,54
2902,25818,4630,2192,2438,0500000US51167,51167,"Russell County, Virginia",Russell County, Virginia,163,113,84,29,448,2,2,0,0,0,0,0,196,97,97,0,0,0,0,0,63,24,24,0,0,0,0,0
2903,20282,2799,1237,1562,0500000US51169,51169,"Scott County, Virginia",Scott County, Virginia,54,42,18,24,203,109,104,5,0,0,0,0,290,124,51,73,17,6,0,6,53,9,0,9,0,0,0,0
2904,37520,4206,1502,2704,0500000US51171,51171,"Shenandoah County, Virginia",Shenandoah County, Virginia,704,120,67,53,1607,83,21,62,0,0,0,0,3085,609,294,315,415,153,125,28,51,0,0,0,400,150,39,111
2905,28131,4980,2216,2764,0500000US51173,51173,"Smyth County, Virginia",Smyth County, Virginia,559,303,202,101,219,38,17,21,46,0,0,0,605,207,90,117,182,47,33,14,104,0,0,0,57,19,19,0
2906,10172,507,119,388,0500000US51175,51175,"Southampton County, Virginia",Southampton County, Virginia,5188,706,292,414,512,42,11,31,0,0,0,0,297,8,4,4,53,0,0,0,30,0,0,0,43,8,4,4
2907,90090,4550,2220,2330,0500000US51177,51177,"Spotsylvania County, Virginia",Spotsylvania County, Virginia,21782,2729,1014,1715,7101,443,201,242,88,27,0,27,13594,1405,620,785,3475,410,239,171,539,77,38,39,5876,854,339,515
2908,87352,3039,1189,1850,0500000US51179,51179,"Stafford County, Virginia",Stafford County, Virginia,25895,1735,787,948,10995,1552,591,961,81,14,0,14,19625,2371,961,1410,5120,495,129,366,393,0,0,0,8461,620,108,512
2909,3406,381,126,255,0500000US51181,51181,"Surry County, Virginia",Surry County, Virginia,2786,661,208,453,109,7,0,7,0,0,0,0,169,0,0,0,0,0,0,0,3,3,2,1,0,0,0,0
2910,3826,425,265,160,0500000US51183,51183,"Sussex County, Virginia",Sussex County, Virginia,4945,551,279,272,176,37,0,37,0,0,0,0,268,46,15,31,59,5,1,4,0,0,0,0,35,18,15,3
2911,37541,6150,2397,3753,0500000US51185,51185,"Tazewell County, Virginia",Tazewell County, Virginia,1145,350,78,272,399,139,61,78,25,15,15,0,340,212,43,169,277,53,53,0,63,14,14,0,88,0,0,0
2912,33820,3550,1588,1962,0500000US51187,51187,"Warren County, Virginia",Warren County, Virginia,1566,210,96,114,1620,103,49,54,0,0,0,0,1884,153,101,52,461,166,122,44,95,34,0,34,807,142,93,49
2913,49877,6503,3285,3218,0500000US51191,51191,"Washington County, Virginia",Washington County, Virginia,510,222,98,124,870,229,133,96,6,0,0,0,786,188,100,88,297,0,0,0,79,7,7,0,69,11,0,11
2914,11266,1606,625,981,0500000US51193,51193,"Westmoreland County, Virginia",Westmoreland County, Virginia,4449,980,485,495,637,35,13,22,0,0,0,0,1153,164,107,57,126,0,0,0,49,9,0,9,573,47,0,47
2915,33241,6585,2871,3714,0500000US51195,51195,"Wise County, Virginia",Wise County, Virginia,843,514,291,223,417,182,96,86,14,14,0,14,336,83,69,14,166,24,15,9,50,0,0,0,77,0,0,0
2916,26659,3116,1343,1773,0500000US51197,51197,"Wythe County, Virginia",Wythe County, Virginia,559,215,200,15,518,127,56,71,0,0,0,0,365,130,88,42,283,174,0,174,44,44,15,29,38,24,24,0
2917,46661,2067,853,1214,0500000US51199,51199,"York County, Virginia",York County, Virginia,8574,651,193,458,4096,145,73,72,189,0,0,0,4311,258,53,205,3930,82,55,27,129,0,0,0,767,149,63,86
2918,81141,3338,1370,1968,0500000US51510,51510,"Alexandria city, Virginia",Alexandria city, Virginia,33903,5677,2610,3067,9325,876,439,437,91,0,0,0,25738,4123,1881,2242,10513,1007,400,607,513,140,140,0,8367,1462,565,897
2919,14702,3036,1253,1783,0500000US51520,51520,"Bristol city, Virginia",Bristol city, Virginia,1162,416,266,150,706,115,14,101,5,5,0,5,71,4,0,4,32,0,0,0,0,0,0,0,131,131,24,107
2920,5316,967,308,659,0500000US51530,51530,"Buena Vista city, Virginia",Buena Vista city, Virginia,316,0,0,0,204,0,0,0,0,0,0,0,74,11,11,0,23,23,0,23,0,0,0,0,54,11,11,0
2921,29518,5610,2751,2859,0500000US51540,51540,"Charlottesville city, Virginia",Charlottesville city, Virginia,8391,2096,606,1490,1541,574,174,400,5,0,0,0,2361,719,268,451,2790,1249,762,487,122,13,0,13,318,87,4,83
2922,134550,6077,2645,3432,0500000US51550,51550,"Chesapeake city, Virginia",Chesapeake city, Virginia,69112,9108,3981,5127,12563,577,206,371,23,5,0,5,15549,2196,953,1243,8255,360,139,221,505,0,0,0,4334,731,300,431
2923,12146,983,357,626,0500000US51570,51570,"Colonial Heights city, Virginia",Colonial Heights city, Virginia,2778,330,175,155,595,95,47,48,14,0,0,0,1091,107,0,107,636,166,142,24,54,0,0,0,415,0,0,0
2924,4495,554,192,362,0500000US51580,51580,"Covington city, Virginia",Covington city, Virginia,688,37,29,8,221,29,9,20,0,0,0,0,145,20,20,0,65,3,0,3,0,0,0,0,0,0,0,0
2925,16085,2588,1250,1338,0500000US51590,51590,"Danville city, Virginia",Danville city, Virginia,19423,5437,2030,3407,1742,706,422,284,38,28,20,8,1783,396,186,210,514,39,9,30,41,8,0,8,106,31,28,3
2926,1354,159,53,106,0500000US51595,51595,"Emporia city, Virginia",Emporia city, Virginia,3115,648,192,456,581,269,156,113,0,0,0,0,328,202,117,85,0,0,0,0,3,0,0,0,4,0,0,0
2927,12463,854,315,539,0500000US51600,51600,"Fairfax city, Virginia",Fairfax city, Virginia,926,58,8,50,1333,242,27,215,0,0,0,0,3836,799,247,552,4270,419,208,211,20,0,0,0,1132,163,123,40
2928,10164,172,62,110,0500000US51610,51610,"Falls Church city, Virginia",Falls Church city, Virginia,684,31,19,12,572,0,0,0,0,0,0,0,1522,55,53,2,1414,46,11,35,13,0,0,0,441,36,34,2
2929,2893,56,32,24,0500000US51620,51620,"Franklin city, Virginia",Franklin city, Virginia,4344,1250,497,753,422,0,0,0,0,0,0,0,241,0,0,0,187,77,42,35,0,0,0,0,34,0,0,0
2930,14928,1888,1028,860,0500000US51630,51630,"Fredericksburg city, Virginia",Fredericksburg city, Virginia,5363,872,422,450,2843,431,178,253,17,0,0,0,3038,435,165,270,1092,72,1,71,63,0,0,0,1333,391,163,228
2931,4431,848,366,482,0500000US51640,51640,"Galax city, Virginia",Galax city, Virginia,607,105,10,95,306,13,0,13,0,0,0,0,1214,485,143,342,22,22,0,22,0,0,0,0,18,0,0,0
2932,49301,4988,2306,2682,0500000US51650,51650,"Hampton city, Virginia",Hampton city, Virginia,65077,13259,5563,7696,6380,603,257,346,152,13,0,13,7918,782,441,341,3048,354,135,219,587,6,5,1,2144,482,254,228
2933,29586,8161,3577,4584,0500000US51660,51660,"Harrisonburg city, Virginia",Harrisonburg city, Virginia,3725,1116,676,440,4039,761,396,365,0,0,0,0,10227,1927,843,1084,1326,376,173,203,52,0,0,0,1551,235,83,152
2934,10059,1494,608,886,0500000US51670,51670,"Hopewell city, Virginia",Hopewell city, Virginia,9624,3147,1434,1713,748,330,59,271,0,0,0,0,1891,610,247,363,302,74,42,32,26,0,0,0,439,79,41,38
2935,3414,637,331,306,0500000US51678,51678,"Lexington city, Virginia",Lexington city, Virginia,344,143,24,119,40,21,0,21,0,0,0,0,190,87,72,15,207,44,0,44,0,0,0,0,176,58,58,0
2936,43106,5538,2140,3398,0500000US51680,51680,"Lynchburg city, Virginia",Lynchburg city, Virginia,21620,5282,2587,2695,1767,211,136,75,47,0,0,0,2832,465,241,224,1585,588,312,276,181,13,0,13,1186,285,153,132
2937,16245,527,197,330,0500000US51683,51683,"Manassas city, Virginia",Manassas city, Virginia,5272,537,260,277,4264,183,100,83,40,0,0,0,15180,1595,599,996,2306,73,34,39,139,3,0,3,3348,912,452,460
2938,5704,219,129,90,0500000US51685,51685,"Manassas Park city, Virginia",Manassas Park city, Virginia,2957,134,8,126,1297,142,91,51,4,0,0,0,6938,506,267,239,1982,19,0,19,7,0,0,0,1056,180,59,121
2939,5289,1001,425,576,0500000US51690,51690,"Martinsville city, Virginia",Martinsville city, Virginia,5635,1829,771,1058,491,83,36,47,13,0,0,0,749,238,129,109,145,72,18,54,40,0,0,0,143,143,52,91
2940,70253,6871,2648,4223,0500000US51700,51700,"Newport News city, Virginia",Newport News city, Virginia,71415,13816,6106,7710,11511,1451,567,884,218,0,0,0,15816,3273,1388,1885,5477,651,146,505,450,0,0,0,3752,935,540,395
2941,93505,9888,4664,5224,0500000US51710,51710,"Norfolk city, Virginia",Norfolk city, Virginia,89654,23266,9851,13415,12334,1980,868,1112,142,13,13,0,17012,2971,1414,1557,8199,845,358,487,643,180,94,86,6997,1514,676,838
2942,3660,1024,380,644,0500000US51720,51720,"Norton city, Virginia",Norton city, Virginia,195,159,159,0,54,54,18,36,0,0,0,0,0,0,0,0,0,0,0,0,0,0,0,0,0,0,0,0
2943,4397,882,402,480,0500000US51730,51730,"Petersburg city, Virginia",Petersburg city, Virginia,23414,5511,2580,2931,773,164,49,115,9,0,0,0,1481,256,109,147,301,42,10,32,134,119,90,29,775,133,104,29
2944,10936,503,285,218,0500000US51735,51735,"Poquoson city, Virginia",Poquoson city, Virginia,161,37,4,33,329,6,6,0,0,0,0,0,352,52,16,36,270,8,0,8,12,0,0,0,33,0,0,0
2945,33873,2980,1195,1785,0500000US51740,51740,"Portsmouth city, Virginia",Portsmouth city, Virginia,47849,9729,3528,6201,3664,681,247,434,309,0,0,0,4060,797,321,476,1360,131,42,89,269,8,8,0,1799,550,136,414
2946,13126,4976,2260,2716,0500000US51750,51750,"Radford city, Virginia",Radford city, Virginia,950,462,207,255,321,77,30,47,4,4,4,0,361,121,54,67,276,261,88,173,25,0,0,0,39,30,24,6
2947,90245,9803,4416,5387,0500000US51760,51760,"Richmond city, Virginia",Richmond city, Virginia,102321,29554,12608,16946,8963,2197,796,1401,20,0,0,0,15054,3115,1075,2040,3709,1233,514,719,328,81,36,45,4777,653,190,463
2948,56301,7489,3474,4015,0500000US51770,51770,"Roanoke city, Virginia",Roanoke city, Virginia,28706,8672,4038,4634,4674,1633,419,1214,48,0,0,0,6314,1749,451,1298,3325,1010,596,414,222,18,0,18,768,174,86,88
2949,19276,1425,659,766,0500000US51775,51775,"Salem city, Virginia",Salem city, Virginia,1413,150,44,106,728,54,25,29,28,0,0,0,779,223,59,164,397,133,28,105,0,0,0,0,360,75,16,59
2950,19172,2307,917,1390,0500000US51790,51790,"Staunton city, Virginia",Staunton city, Virginia,2319,324,179,145,781,41,23,18,27,0,0,0,654,111,58,53,340,14,0,14,95,70,0,70,106,0,0,0
2951,44407,1959,879,1080,0500000US51800,51800,"Suffolk city, Virginia",Suffolk city, Virginia,37619,5669,2174,3495,4119,383,221,162,9,0,0,0,4093,501,256,245,1956,130,94,36,153,0,0,0,1003,18,18,0
2952,269229,14402,5972,8430,0500000US51810,51810,"Virginia Beach city, Virginia",Virginia Beach city, Virginia,82439,9821,4289,5532,28719,2499,1094,1405,454,67,54,13,36643,3884,1696,2188,31859,1789,850,939,1228,197,175,22,9504,1312,483,829
2953,16449,1901,732,1169,0500000US51820,51820,"Waynesboro city, Virginia",Waynesboro city, Virginia,2741,531,268,263,710,183,173,10,95,0,0,0,1910,595,233,362,378,226,184,42,182,48,0,48,208,99,31,68
2954,7294,850,330,520,0500000US51830,51830,"Williamsburg city, Virginia",Williamsburg city, Virginia,1902,425,291,134,649,80,70,10,0,0,0,0,802,118,88,30,197,76,22,54,36,36,0,36,95,90,76,14
2955,17294,1647,853,794,0500000US51840,51840,"Winchester city, Virginia",Winchester city, Virginia,2660,501,163,338,2268,578,237,341,8,0,0,0,4923,1611,773,838,585,13,0,13,57,0,0,0,535,294,49,245
2956,6428,713,315,398,0500000US53001,53001,"Adams County, Washington",Adams County, Washington,182,66,66,0,783,113,52,61,85,0,0,0,12552,3749,1605,2144,113,25,17,8,702,455,162,293,6117,1769,890,879
2957,20101,2058,847,1211,0500000US53003,53003,"Asotin County, Washington",Asotin County, Washington,109,6,0,6,918,326,131,195,63,0,0,0,958,404,68,336,234,13,0,13,241,132,132,0,219,46,0,46
2958,138543,9265,4001,5264,0500000US53005,53005,"Benton County, Washington",Benton County, Washington,3339,612,440,172,10579,2182,1199,983,177,0,0,0,44255,9581,4686,4895,5647,250,48,202,1751,323,141,182,16718,3170,1383,1787
2959,51119,4126,1756,2370,0500000US53007,53007,"Chelan County, Washington",Chelan County, Washington,310,52,2,50,4744,354,205,149,32,7,3,4,21210,3699,1879,1820,624,102,100,2,359,56,1,55,11497,2289,1010,1279
2960,62100,7057,3457,3600,0500000US53009,53009,"Clallam County, Washington",Clallam County, Washington,772,313,149,164,3408,478,288,190,26,2,2,0,5086,1266,556,710,1074,208,74,134,3670,956,497,459,1118,97,46,51
2961,370354,29614,11990,17624,0500000US53011,53011,"Clark County, Washington",Clark County, Washington,8472,1292,631,661,29899,3604,1884,1720,3646,629,360,269,47428,6222,2842,3380,22819,2553,960,1593,2618,260,116,144,12612,1717,794,923
2962,3380,213,94,119,0500000US53013,53013,"Columbia County, Washington",Columbia County, Washington,53,20,20,0,223,19,10,9,0,0,0,0,322,18,0,18,50,0,0,0,9,0,0,0,199,18,0,18
2963,87924,11048,5099,5949,0500000US53015,53015,"Cowlitz County, Washington",Cowlitz County, Washington,1032,146,124,22,7098,1152,559,593,312,1,0,1,9869,1885,785,1100,1214,30,16,14,1703,679,293,386,1903,213,107,106
2964,26734,2171,909,1262,0500000US53017,53017,"Douglas County, Washington",Douglas County, Washington,198,52,30,22,2055,563,156,407,138,13,13,0,13518,1897,834,1063,260,15,0,15,408,112,43,69,10637,1572,709,863
2965,5544,896,507,389,0500000US53019,53019,"Ferry County, Washington",Ferry County, Washington,3,0,0,0,613,100,64,36,16,8,0,8,361,63,46,17,34,12,1,11,1047,223,137,86,13,6,6,0
2966,36151,2692,1034,1658,0500000US53021,53021,"Franklin County, Washington",Franklin County, Washington,1869,529,231,298,9147,2054,1310,744,180,10,10,0,48823,9173,4593,4580,1847,78,71,7,1136,338,219,119,18078,3488,1702,1786
2967,1981,168,85,83,0500000US53023,53023,"Garfield County, Washington",Garfield County, Washington,0,0,0,0,134,18,6,12,0,0,0,0,31,0,0,0,91,0,0,0,0,0,0,0,0,0,0,0
2968,50455,5166,2201,2965,0500000US53025,53025,"Grant County, Washington",Grant County, Washington,994,21,3,18,6038,1082,614,468,0,0,0,0,40302,8472,4100,4372,895,85,41,44,1295,105,32,73,23960,4822,2250,2572
2969,56211,7335,3393,3942,0500000US53027,53027,"Grays Harbor County, Washington",Grays Harbor County, Washington,251,20,15,5,3407,606,260,346,180,38,25,13,7296,1733,840,893,939,32,21,11,2957,602,337,265,1109,344,231,113
2970,64434,4605,1866,2739,0500000US53029,53029,"Island County, Washington",Island County, Washington,1920,144,103,41,5005,268,127,141,327,21,8,13,6423,805,377,428,3868,231,50,181,906,86,58,28,1252,200,55,145
2971,27349,3242,1591,1651,0500000US53031,53031,"Jefferson County, Washington",Jefferson County, Washington,125,36,4,32,1176,350,196,154,19,0,0,0,1133,373,208,165,485,75,10,65,486,155,33,122,551,93,73,20
2972,1279645,76997,35252,41745,0500000US53033,53033,"King County, Washington",King County, Washington,142665,27133,12867,14266,158105,17546,8586,8960,16696,2054,909,1145,215039,30721,13967,16754,402700,33393,14964,18429,13028,2737,1366,1371,95688,14552,6604,7948
2973,198084,14693,6160,8533,0500000US53035,53035,"Kitsap County, Washington",Kitsap County, Washington,6680,1125,406,719,21408,2321,1057,1264,2384,383,261,122,20471,2107,910,1197,12986,699,293,406,2539,365,138,227,5794,813,430,383
2974,36875,5656,2254,3402,0500000US53037,53037,"Kittitas County, Washington",Kittitas County, Washington,396,228,46,182,2427,812,364,448,254,20,20,0,3918,810,190,620,529,115,14,101,197,50,21,29,1836,253,13,240
2975,18030,2923,1359,1564,0500000US53039,53039,"Klickitat County, Washington",Klickitat County, Washington,252,60,17,43,619,144,34,110,3,0,0,0,2629,124,69,55,132,15,12,3,415,133,104,29,394,17,11,6
2976,64905,7657,3726,3931,0500000US53041,53041,"Lewis County, Washington",Lewis County, Washington,384,106,94,12,5609,944,392,552,151,0,0,0,8030,1927,891,1036,833,74,34,40,450,138,84,54,1753,606,458,148
2977,9677,1174,604,570,0500000US53043,53043,"Lincoln County, Washington",Lincoln County, Washington,49,14,6,8,280,23,23,0,29,0,0,0,367,32,17,15,55,0,0,0,184,1,0,1,81,1,1,0
2978,51091,5096,2317,2779,0500000US53045,53045,"Mason County, Washington",Mason County, Washington,432,19,15,4,4663,806,418,388,392,2,0,2,6582,2166,1193,973,644,74,27,47,1296,357,181,176,3767,1485,803,682
2979,26780,3778,1903,1875,0500000US53047,53047,"Okanogan County, Washington",Okanogan County, Washington,52,1,0,1,2557,833,437,396,42,12,0,12,8534,3285,1544,1741,249,38,25,13,4131,980,434,546,4777,1957,1086,871
2980,17590,2138,962,1176,0500000US53049,53049,"Pacific County, Washington",Pacific County, Washington,84,46,33,13,943,85,0,85,75,0,0,0,2088,588,302,286,405,83,58,25,651,198,103,95,1106,383,189,194
2981,11692,1161,509,652,0500000US53051,53051,"Pend Oreille County, Washington",Pend Oreille County, Washington,22,0,0,0,707,62,62,0,3,0,0,0,532,82,50,32,118,9,0,9,434,24,14,10,362,54,30,24
2982,576366,43690,18744,24946,0500000US53053,53053,"Pierce County, Washington",Pierce County, Washington,59486,9495,4984,4511,82632,8454,3814,4640,13095,982,493,489,98198,13891,6374,7517,56289,6929,3357,3572,9567,1336,653,683,27206,4937,2120,2817
2983,14762,1382,579,803,0500000US53055,53055,"San Juan County, Washington",San Juan County, Washington,141,0,0,0,554,66,43,23,14,2,2,0,1084,239,43,196,231,27,10,17,149,16,10,6,361,133,2,131
2984,92721,7601,3010,4591,0500000US53057,53057,"Skagit County, Washington",Skagit County, Washington,953,117,68,49,5886,735,327,408,194,22,10,12,23321,4618,2009,2609,2207,210,104,106,2394,557,248,309,11621,2580,1275,1305
2985,10319,1129,554,575,0500000US53059,53059,"Skamania County, Washington",Skamania County, Washington,5,2,0,2,305,54,12,42,30,4,4,0,778,19,6,13,158,47,0,47,214,21,21,0,114,8,3,5
2986,545659,33240,14657,18583,0500000US53061,53061,"Snohomish County, Washington",Snohomish County, Washington,25598,2543,1192,1351,57704,6132,3253,2879,3864,261,57,204,84099,9106,4262,4844,91692,7226,3258,3968,7539,1064,479,585,28758,3478,1390,2088
2987,419930,48206,22496,25710,0500000US53063,53063,"Spokane County, Washington",Spokane County, Washington,8542,1977,941,1036,27350,4729,2304,2425,3004,1287,632,655,29175,6055,2649,3406,10955,1539,881,658,5879,1650,525,1125,7572,1959,993,966
2988,38656,4613,2222,2391,0500000US53065,53065,"Stevens County, Washington",Stevens County, Washington,193,42,15,27,1944,248,114,134,90,11,2,9,1683,279,173,106,332,57,10,47,2014,554,289,265,106,8,8,0
2989,208111,18217,8114,10103,0500000US53067,53067,"Thurston County, Washington",Thurston County, Washington,8152,1262,734,528,21568,2217,1033,1184,2526,395,169,226,26154,3649,1534,2115,16244,1983,927,1056,3262,480,295,185,5344,959,510,449
2990,3658,352,145,207,0500000US53069,53069,"Wahkiakum County, Washington",Wahkiakum County, Washington,49,3,2,1,89,6,5,1,0,0,0,0,324,26,9,17,72,0,0,0,38,0,0,0,246,26,9,17
2991,40704,3837,1708,2129,0500000US53071,53071,"Walla Walla County, Washington",Walla Walla County, Washington,592,148,72,76,2915,339,144,195,27,0,0,0,12206,1946,779,1167,841,177,49,128,332,60,21,39,4290,1078,412,666
2992,170975,21130,9425,11705,0500000US53073,53073,"Whatcom County, Washington",Whatcom County, Washington,2097,589,243,346,12965,2358,999,1359,552,15,7,8,21267,4225,1847,2378,8852,1647,675,972,5570,1177,667,510,9212,1799,769,1030
2993,33917,8116,4130,3986,0500000US53075,53075,"Whitman County, Washington",Whitman County, Washington,742,407,292,115,2330,523,169,354,58,55,14,41,2224,642,308,334,3490,1271,641,630,175,68,57,11,925,314,112,202
2994,104690,11051,4892,6159,0500000US53077,53077,"Yakima County, Washington",Yakima County, Washington,2477,435,278,157,18838,2804,1178,1626,1141,58,18,40,123418,25242,10899,14343,2282,435,193,242,8541,3009,1405,1604,35872,8592,4023,4569
2995,15122,3094,1468,1626,0500000US54001,54001,"Barbour County, West Virginia",Barbour County, West Virginia,55,23,7,16,475,183,71,112,0,0,0,0,184,32,3,29,50,0,0,0,27,3,3,0,59,0,0,0
2996,96663,9011,3332,5679,0500000US54003,54003,"Berkeley County, West Virginia",Berkeley County, West Virginia,9190,2440,1026,1414,3805,192,82,110,0,0,0,0,5399,725,381,344,1354,113,0,113,111,53,0,53,1910,460,236,224
2997,21071,3987,1750,2237,0500000US54005,54005,"Boone County, West Virginia",Boone County, West Virginia,140,52,41,11,350,14,0,14,0,0,0,0,46,0,0,0,0,0,0,0,0,0,0,0,6,0,0,0
2998,12585,2404,1044,1360,0500000US54007,54007,"Braxton County, West Virginia",Braxton County, West Virginia,80,4,0,4,932,136,136,0,19,0,0,0,17,0,0,0,0,0,0,0,46,0,0,0,10,0,0,0
2999,20176,2524,862,1662,0500000US54009,54009,"Brooke County, West Virginia",Brooke County, West Virginia,178,21,19,2,454,43,16,27,31,0,0,0,183,43,32,11,123,1,0,1,21,0,0,0,45,0,0,0
3000,80601,16230,7473,8757,0500000US54011,54011,"Cabell County, West Virginia",Cabell County, West Virginia,3836,1924,784,1140,2753,849,211,638,17,0,0,0,1307,467,201,266,1040,416,279,137,106,41,6,35,473,392,130,262
3001,7070,1719,772,947,0500000US54013,54013,"Calhoun County, West Virginia",Calhoun County, West Virginia,0,0,0,0,50,28,9,19,0,0,0,0,0,0,0,0,0,0,0,0,0,0,0,0,0,0,0,0
3002,8395,2386,1113,1273,0500000US54015,54015,"Clay County, West Virginia",Clay County, West Virginia,7,7,4,3,51,0,0,0,0,0,0,0,6,0,0,0,0,0,0,0,15,0,0,0,0,0,0,0
3003,7476,998,461,537,0500000US54017,54017,"Doddridge County, West Virginia",Doddridge County, West Virginia,0,0,0,0,97,0,0,0,0,0,0,0,7,7,7,0,81,0,0,0,22,0,0,0,7,7,7,0
3004,38513,8011,3663,4348,0500000US54019,54019,"Fayette County, West Virginia",Fayette County, West Virginia,2060,733,300,433,462,108,55,53,26,0,0,0,447,32,12,20,15,0,0,0,89,24,0,24,61,4,0,4
3005,5889,612,270,342,0500000US54021,54021,"Gilmer County, West Virginia",Gilmer County, West Virginia,221,179,134,45,72,26,17,9,0,0,0,0,176,0,0,0,84,0,0,0,0,0,0,0,121,0,0,0
3006,11039,1172,547,625,0500000US54023,54023,"Grant County, West Virginia",Grant County, West Virginia,184,60,60,0,73,0,0,0,29,0,0,0,83,0,0,0,34,0,0,0,0,0,0,0,37,0,0,0
3007,31392,5202,2385,2817,0500000US54025,54025,"Greenbrier County, West Virginia",Greenbrier County, West Virginia,975,208,69,139,925,411,101,310,0,0,0,0,671,24,18,6,234,161,143,18,15,0,0,0,206,9,0,9
3008,21649,2922,1477,1445,0500000US54027,54027,"Hampshire County, West Virginia",Hampshire County, West Virginia,229,132,127,5,311,130,32,98,0,0,0,0,322,77,63,14,56,8,0,8,40,0,0,0,8,0,0,0
3009,26692,3507,1496,2011,0500000US54029,54029,"Hancock County, West Virginia",Hancock County, West Virginia,643,85,85,0,796,220,128,92,6,0,0,0,450,215,102,113,144,27,0,27,13,7,7,0,0,0,0,0
3010,12264,1956,896,1060,0500000US54031,54031,"Hardy County, West Virginia",Hardy County, West Virginia,708,173,37,136,81,72,72,0,0,0,0,0,112,0,0,0,381,0,0,0,95,0,0,0,0,0,0,0
3011,62295,8482,3575,4907,0500000US54033,54033,"Harrison County, West Virginia",Harrison County, West Virginia,982,326,210,116,1623,674,243,431,13,0,0,0,1117,119,56,63,414,0,0,0,4,3,1,2,225,16,0,16
3012,27556,4872,2331,2541,0500000US54035,54035,"Jackson County, West Virginia",Jackson County, West Virginia,89,19,19,0,493,81,81,0,0,0,0,0,271,66,0,66,88,0,0,0,147,0,0,0,0,0,0,0
3013,45849,4022,1534,2488,0500000US54037,54037,"Jefferson County, West Virginia",Jefferson County, West Virginia,3117,329,216,113,2339,260,137,123,0,0,0,0,3312,425,237,188,787,21,0,21,141,31,10,21,1249,335,159,176
3014,155430,24527,11232,13295,0500000US54039,54039,"Kanawha County, West Virginia",Kanawha County, West Virginia,12107,3733,2068,1665,6021,1725,671,1054,225,0,0,0,2012,325,213,112,2204,151,14,137,335,178,108,70,395,67,45,22
3015,14811,2614,1161,1453,0500000US54041,54041,"Lewis County, West Virginia",Lewis County, West Virginia,0,0,0,0,508,137,33,104,0,0,0,0,185,0,0,0,67,42,42,0,69,0,0,0,195,0,0,0
3016,19939,4124,1896,2228,0500000US54043,54043,"Lincoln County, West Virginia",Lincoln County, West Virginia,149,116,116,0,227,153,50,103,39,0,0,0,132,81,19,62,60,0,0,0,1,1,1,0,0,0,0,0
3017,30717,7682,3591,4091,0500000US54045,54045,"Logan County, West Virginia",Logan County, West Virginia,463,176,11,165,512,246,146,100,7,7,0,7,307,218,170,48,18,1,0,1,34,29,6,23,0,0,0,0
3018,15468,5102,2155,2947,0500000US54047,54047,"McDowell County, West Virginia",McDowell County, West Virginia,795,250,141,109,310,73,35,38,0,0,0,0,93,39,3,36,10,0,0,0,14,14,14,0,23,0,0,0
3019,50642,7359,3292,4067,0500000US54049,54049,"Marion County, West Virginia",Marion County, West Virginia,1845,598,372,226,969,188,135,53,0,0,0,0,734,129,86,43,312,24,12,12,128,0,0,0,476,230,61,169
3020,29258,4645,1974,2671,0500000US54051,54051,"Marshall County, West Virginia",Marshall County, West Virginia,194,18,12,6,466,20,11,9,0,0,0,0,291,19,9,10,109,0,0,0,57,0,0,0,31,0,0,0
3021,24967,3534,1373,2161,0500000US54053,54053,"Mason County, West Virginia",Mason County, West Virginia,52,26,10,16,325,57,22,35,0,0,0,0,194,0,0,0,297,0,0,0,19,0,0,0,81,46,46,0
3022,52300,9215,4131,5084,0500000US54055,54055,"Mercer County, West Virginia",Mercer County, West Virginia,3471,976,383,593,1489,267,141,126,0,0,0,0,699,189,21,168,276,36,11,25,70,1,1,0,27,2,0,2
3023,24518,3110,1100,2010,0500000US54057,54057,"Mineral County, West Virginia",Mineral County, West Virginia,756,143,29,114,455,30,16,14,0,0,0,0,252,75,41,34,69,0,0,0,4,0,0,0,88,79,73,6
3024,22651,6185,2801,3384,0500000US54059,54059,"Mingo County, West Virginia",Mingo County, West Virginia,445,76,4,72,308,41,0,41,0,0,0,0,61,61,61,0,42,0,0,0,0,0,0,0,146,129,0,129
3025,88089,16974,8019,8955,0500000US54061,54061,"Monongalia County, West Virginia",Monongalia County, West Virginia,3355,921,469,452,3149,890,372,518,1,0,0,0,1966,422,214,208,3487,872,463,409,64,28,1,27,912,440,399,41
3026,12696,1739,865,874,0500000US54063,54063,"Monroe County, West Virginia",Monroe County, West Virginia,149,7,7,0,216,107,0,107,0,0,0,0,141,10,5,5,0,0,0,0,10,10,0,10,1,1,0,1
3027,16785,934,400,534,0500000US54065,54065,"Morgan County, West Virginia",Morgan County, West Virginia,94,37,24,13,466,58,25,33,0,0,0,0,260,0,0,0,0,0,0,0,108,0,0,0,123,0,0,0
3028,23908,4588,1950,2638,0500000US54067,54067,"Nicholas County, West Virginia",Nicholas County, West Virginia,184,2,1,1,250,22,14,8,0,0,0,0,114,14,14,0,102,0,0,0,149,83,83,0,58,0,0,0
3029,36217,4937,2079,2858,0500000US54069,54069,"Ohio County, West Virginia",Ohio County, West Virginia,1452,356,218,138,1079,179,68,111,0,0,0,0,383,149,71,78,186,10,9,1,132,60,0,60,115,6,6,0
3030,6471,959,386,573,0500000US54071,54071,"Pendleton County, West Virginia",Pendleton County, West Virginia,246,12,4,8,11,0,0,0,0,0,0,0,65,42,21,21,0,0,0,0,16,0,0,0,64,0,0,0
3031,6694,572,282,290,0500000US54073,54073,"Pleasants County, West Virginia",Pleasants County, West Virginia,0,0,0,0,35,21,0,21,0,0,0,0,217,0,0,0,0,0,0,0,0,0,0,0,210,0,0,0
3032,7951,1445,659,786,0500000US54075,54075,"Pocahontas County, West Virginia",Pocahontas County, West Virginia,4,0,0,0,75,75,66,9,0,0,0,0,24,11,2,9,11,0,0,0,0,0,0,0,23,2,2,0
3033,29614,4179,1818,2361,0500000US54077,54077,"Preston County, West Virginia",Preston County, West Virginia,139,1,1,0,476,282,133,149,14,0,0,0,82,58,15,43,61,39,19,20,154,20,12,8,19,4,4,0
3034,53186,5640,2425,3215,0500000US54079,54079,"Putnam County, West Virginia",Putnam County, West Virginia,455,113,73,40,1216,212,177,35,40,0,0,0,671,19,0,19,428,48,9,39,51,0,0,0,131,19,0,19
3035,62902,12890,5569,7321,0500000US54081,54081,"Raleigh County, West Virginia",Raleigh County, West Virginia,4512,924,389,535,2162,645,436,209,0,0,0,0,1080,341,189,152,533,0,0,0,184,0,0,0,682,149,83,66
3036,24675,4119,1837,2282,0500000US54083,54083,"Randolph County, West Virginia",Randolph County, West Virginia,332,172,70,102,882,58,0,58,0,0,0,0,229,11,11,0,145,0,0,0,40,0,0,0,77,0,0,0
3037,9335,1432,646,786,0500000US54085,54085,"Ritchie County, West Virginia",Ritchie County, West Virginia,18,0,0,0,162,83,75,8,0,0,0,0,3,0,0,0,38,36,3,33,0,0,0,0,57,0,0,0
3038,13063,2684,1191,1493,0500000US54087,54087,"Roane County, West Virginia",Roane County, West Virginia,12,2,2,0,424,355,153,202,0,0,0,0,162,37,23,14,14,0,0,0,7,0,0,0,15,15,15,0
3039,11135,2120,935,1185,0500000US54089,54089,"Summers County, West Virginia",Summers County, West Virginia,329,58,29,29,254,96,50,46,0,0,0,0,191,91,21,70,0,0,0,0,0,0,0,0,0,0,0,0
3040,15695,2617,1272,1345,0500000US54091,54091,"Taylor County, West Virginia",Taylor County, West Virginia,102,4,2,2,338,43,7,36,0,0,0,0,161,129,24,105,23,0,0,0,0,0,0,0,97,0,0,0
3041,6543,626,308,318,0500000US54093,54093,"Tucker County, West Virginia",Tucker County, West Virginia,44,31,0,31,89,32,8,24,0,0,0,0,31,31,0,31,12,4,0,4,0,0,0,0,23,0,0,0
3042,8329,1171,500,671,0500000US54095,54095,"Tyler County, West Virginia",Tyler County, West Virginia,10,0,0,0,193,52,21,31,0,0,0,0,45,38,0,38,27,4,0,4,11,3,0,3,5,0,0,0
3043,22075,4370,1824,2546,0500000US54097,54097,"Upshur County, West Virginia",Upshur County, West Virginia,338,66,25,41,485,96,75,21,0,0,0,0,263,31,31,0,0,0,0,0,27,14,0,14,30,0,0,0
3044,38604,7720,3357,4363,0500000US54099,54099,"Wayne County, West Virginia",Wayne County, West Virginia,241,29,23,6,479,33,19,14,0,0,0,0,272,29,12,17,119,24,9,15,69,0,0,0,127,0,0,0
3045,8087,2157,934,1223,0500000US54101,54101,"Webster County, West Virginia",Webster County, West Virginia,0,0,0,0,128,69,31,38,0,0,0,0,5,0,0,0,0,0,0,0,0,0,0,0,5,0,0,0
3046,14472,2935,1376,1559,0500000US54103,54103,"Wetzel County, West Virginia",Wetzel County, West Virginia,113,27,0,27,197,7,7,0,0,0,0,0,151,0,0,0,0,0,0,0,0,0,0,0,44,43,14,29
3047,5569,1107,478,629,0500000US54105,54105,"Wirt County, West Virginia",Wirt County, West Virginia,78,78,19,59,88,75,44,31,0,0,0,0,20,16,10,6,0,0,0,0,0,0,0,0,0,0,0,0
3048,79159,11871,5132,6739,0500000US54107,54107,"Wood County, West Virginia",Wood County, West Virginia,1143,632,260,372,1394,257,130,127,1,1,0,1,956,159,12,147,357,5,5,0,300,16,0,16,39,0,0,0
3049,20023,4253,1922,2331,0500000US54109,54109,"Wyoming County, West Virginia",Wyoming County, West Virginia,233,116,44,72,242,29,15,14,0,0,0,0,85,18,18,0,60,0,0,0,0,0,0,0,25,0,0,0
3050,17738,1953,814,1139,0500000US55001,55001,"Adams County, Wisconsin",Adams County, Wisconsin,131,56,24,32,499,127,65,62,3,0,0,0,633,113,51,62,131,23,3,20,93,13,11,2,138,0,0,0
3051,12304,1635,708,927,0500000US55003,55003,"Ashland County, Wisconsin",Ashland County, Wisconsin,72,64,43,21,634,138,61,77,87,66,0,66,456,91,53,38,81,29,0,29,1451,411,254,157,43,26,14,12
3052,41171,4772,1993,2779,0500000US55005,55005,"Barron County, Wisconsin",Barron County, Wisconsin,657,24,18,6,737,201,155,46,0,0,0,0,1169,215,90,125,299,64,46,18,269,99,30,69,582,53,26,27
3053,12635,1161,488,673,0500000US55007,55007,"Bayfield County, Wisconsin",Bayfield County, Wisconsin,48,0,0,0,422,28,18,10,0,0,0,0,322,167,93,74,70,7,3,4,1525,418,209,209,18,8,8,0
3054,205307,13655,5824,7831,0500000US55009,55009,"Brown County, Wisconsin",Brown County, Wisconsin,5655,2192,1033,1159,11500,2321,855,1466,39,8,0,8,23021,4695,2705,1990,8276,880,394,486,6064,1795,842,953,9286,3026,1829,1197
3055,12419,1003,366,637,0500000US55011,55011,"Buffalo County, Wisconsin",Buffalo County, Wisconsin,60,41,33,8,185,43,17,26,0,0,0,0,268,25,13,12,6,0,0,0,45,0,0,0,123,8,8,0
3056,13744,1555,716,839,0500000US55013,55013,"Burnett County, Wisconsin",Burnett County, Wisconsin,82,35,9,26,536,128,101,27,1,0,0,0,285,77,52,25,56,4,0,4,515,139,74,65,28,13,10,3
3057,45091,2207,959,1248,0500000US55015,55015,"Calumet County, Wisconsin",Calumet County, Wisconsin,445,121,0,121,967,184,10,174,1,1,1,0,2168,296,93,203,1185,13,8,5,253,5,0,5,373,25,17,8
3058,58194,5602,2430,3172,0500000US55017,55017,"Chippewa County, Wisconsin",Chippewa County, Wisconsin,314,20,18,2,945,118,47,71,2,0,0,0,904,241,100,141,863,41,0,41,116,92,14,78,89,8,0,8
3059,31345,3528,1566,1962,0500000US55019,55019,"Clark County, Wisconsin",Clark County, Wisconsin,146,14,0,14,796,257,187,70,1,0,0,0,1730,478,261,217,90,5,4,1,58,2,2,0,452,63,27,36
3060,52004,3355,1495,1860,0500000US55021,55021,"Columbia County, Wisconsin",Columbia County, Wisconsin,561,61,30,31,890,65,48,17,2,0,0,0,1959,270,156,114,432,8,0,8,221,11,6,5,613,84,44,40
3061,14788,2000,932,1068,0500000US55023,55023,"Crawford County, Wisconsin",Crawford County, Wisconsin,46,7,1,6,289,61,58,3,0,0,0,0,203,101,56,45,96,0,0,0,13,3,3,0,4,0,0,0
3062,416827,35884,16817,19067,0500000US55025,55025,"Dane County, Wisconsin",Dane County, Wisconsin,25357,5791,2519,3272,23959,3859,1916,1943,321,39,37,2,34513,6355,3125,3230,31012,5828,3128,2700,1581,315,157,158,9023,2753,702,2051
3063,75921,5746,2526,3220,0500000US55027,55027,"Dodge County, Wisconsin",Dodge County, Wisconsin,1136,193,91,102,2038,151,76,75,23,7,7,0,4047,639,306,333,530,0,0,0,189,1,0,1,608,154,87,67
3064,25549,2055,955,1100,0500000US55029,55029,"Door County, Wisconsin",Door County, Wisconsin,163,25,2,23,409,52,52,0,0,0,0,0,911,114,93,21,131,1,0,1,197,1,1,0,204,88,44,44
3065,38675,4210,1804,2406,0500000US55031,55031,"Douglas County, Wisconsin",Douglas County, Wisconsin,441,72,31,41,1285,120,83,37,0,0,0,0,683,69,24,45,432,22,8,14,776,395,264,131,227,17,14,3
3066,38404,4165,2058,2107,0500000US55033,55033,"Dunn County, Wisconsin",Dunn County, Wisconsin,217,127,67,60,816,122,82,40,22,0,0,0,776,160,74,86,1223,244,111,133,80,9,9,0,137,5,4,1
3067,89508,10630,4433,6197,0500000US55035,55035,"Eau Claire County, Wisconsin",Eau Claire County, Wisconsin,1157,402,372,30,2827,821,392,429,310,34,0,34,2502,866,463,403,3856,418,273,145,295,132,86,46,394,3,1,2
3068,4141,414,199,215,0500000US55037,55037,"Florence County, Wisconsin",Florence County, Wisconsin,26,0,0,0,57,6,3,3,0,0,0,0,15,0,0,0,0,0,0,0,20,3,3,0,0,0,0,0
3069,88379,6259,2777,3482,0500000US55039,55039,"Fond du Lac County, Wisconsin",Fond du Lac County, Wisconsin,1156,325,205,120,2635,676,321,355,35,0,0,0,5294,770,243,527,1196,184,96,88,382,31,8,23,2178,52,0,52
3070,6809,782,350,432,0500000US55041,55041,"Forest County, Wisconsin",Forest County, Wisconsin,73,58,26,32,376,61,25,36,0,0,0,0,247,88,26,62,67,14,0,14,1242,415,242,173,85,17,17,0
3071,45736,6621,3213,3408,0500000US55043,55043,"Grant County, Wisconsin",Grant County, Wisconsin,496,319,140,179,476,85,45,40,0,0,0,0,814,188,116,72,473,25,0,25,19,8,4,4,88,20,6,14
3072,34141,2747,1242,1505,0500000US55045,55045,"Green County, Wisconsin",Green County, Wisconsin,200,32,30,2,608,221,63,158,9,9,0,9,1078,117,56,61,101,5,5,0,70,1,0,1,374,49,49,0
3073,17040,1713,730,983,0500000US55047,55047,"Green Lake County, Wisconsin",Green Lake County, Wisconsin,156,19,19,0,362,86,12,74,0,0,0,0,944,148,69,79,54,0,0,0,46,9,9,0,192,1,0,1
3074,22132,1680,738,942,0500000US55049,55049,"Iowa County, Wisconsin",Iowa County, Wisconsin,187,28,16,12,406,49,25,24,22,22,15,7,455,78,22,56,157,13,0,13,56,0,0,0,99,9,9,0
3075,5303,696,285,411,0500000US55051,55051,"Iron County, Wisconsin",Iron County, Wisconsin,5,0,0,0,113,19,6,13,0,0,0,0,74,0,0,0,25,0,0,0,61,29,24,5,19,0,0,0
3076,16980,1680,693,987,0500000US55053,55053,"Jackson County, Wisconsin",Jackson County, Wisconsin,72,24,6,18,602,233,118,115,12,9,3,6,646,141,70,71,97,15,15,0,1007,279,107,172,219,14,14,0
3077,73398,5513,2234,3279,0500000US55055,55055,"Jefferson County, Wisconsin",Jefferson County, Wisconsin,510,74,13,61,2374,310,106,204,45,17,17,0,5928,1021,525,496,409,19,0,19,144,11,0,11,1870,233,133,100
3078,23255,3425,1742,1683,0500000US55057,55057,"Juneau County, Wisconsin",Juneau County, Wisconsin,303,110,110,0,464,97,65,32,0,0,0,0,771,123,59,64,83,4,0,4,255,42,27,15,255,0,0,0
3079,123617,11339,4750,6589,0500000US55059,55059,"Kenosha County, Wisconsin",Kenosha County, Wisconsin,10975,3245,1426,1819,9011,1565,857,708,81,0,0,0,22418,3784,1883,1901,2626,284,220,64,660,133,48,85,3695,832,331,501
3080,19033,1187,546,641,0500000US55061,55061,"Kewaunee County, Wisconsin",Kewaunee County, Wisconsin,136,22,22,0,280,25,1,24,0,0,0,0,620,125,53,72,89,0,0,0,107,19,2,17,155,63,15,48
3081,101154,11661,4946,6715,0500000US55063,55063,"La Crosse County, Wisconsin",La Crosse County, Wisconsin,1851,734,311,423,3162,511,170,341,16,2,0,2,2215,339,168,171,4986,606,317,289,263,50,0,50,842,96,42,54
3082,15510,1729,773,956,0500000US55065,55065,"Lafayette County, Wisconsin",Lafayette County, Wisconsin,76,16,5,11,282,22,9,13,0,0,0,0,673,84,47,37,75,7,3,4,49,0,0,0,100,11,2,9
3083,17742,2196,1093,1103,0500000US55067,55067,"Langlade County, Wisconsin",Langlade County, Wisconsin,87,0,0,0,574,68,31,37,2,0,0,0,412,67,42,25,41,4,0,4,113,39,34,5,96,47,15,32
3084,25871,2299,1052,1247,0500000US55069,55069,"Lincoln County, Wisconsin",Lincoln County, Wisconsin,65,0,0,0,480,83,26,57,0,0,0,0,460,105,51,54,65,11,5,6,115,16,11,5,44,0,0,0
3085,70142,5353,1846,3507,0500000US55071,55071,"Manitowoc County, Wisconsin",Manitowoc County, Wisconsin,890,323,200,123,1808,351,130,221,8,0,0,0,3323,520,258,262,2162,494,165,329,334,54,12,42,503,40,4,36
3086,117180,8600,3832,4768,0500000US55073,55073,"Marathon County, Wisconsin",Marathon County, Wisconsin,520,129,42,87,3974,845,466,379,77,24,0,24,3785,1281,581,700,7278,1193,583,610,232,80,24,56,1862,151,67,84
3087,37569,4107,1688,2419,0500000US55075,55075,"Marinette County, Wisconsin",Marinette County, Wisconsin,252,107,8,99,676,43,26,17,21,21,9,12,718,96,38,58,134,10,2,8,189,37,3,34,143,14,0,14
3088,14176,1292,522,770,0500000US55077,55077,"Marquette County, Wisconsin",Marquette County, Wisconsin,82,23,21,2,288,42,18,24,0,0,0,0,523,152,63,89,84,7,7,0,70,25,23,2,88,4,0,4
3089,432,46,31,15,0500000US55078,55078,"Menominee County, Wisconsin",Menominee County, Wisconsin,7,7,5,2,235,27,12,15,0,0,0,0,329,71,64,7,8,0,0,0,3818,1207,545,662,4,0,0,0
3090,465330,44225,20140,24085,0500000US55079,55079,"Milwaukee County, Wisconsin",Milwaukee County, Wisconsin,244386,77191,33435,43756,47398,10124,4317,5807,327,12,5,7,144222,32366,15086,17280,41517,9568,4996,4572,4933,958,432,526,60196,14502,7094,7408
3091,40900,3906,1822,2084,0500000US55081,55081,"Monroe County, Wisconsin",Monroe County, Wisconsin,774,48,44,4,869,149,37,112,11,0,0,0,2117,342,142,200,373,3,3,0,483,98,48,50,958,76,57,19
3092,35364,2943,1392,1551,0500000US55083,55083,"Oconto County, Wisconsin",Oconto County, Wisconsin,89,6,6,0,801,179,82,97,0,0,0,0,729,186,149,37,111,5,5,0,486,114,46,68,27,2,2,0
3093,33054,2398,1215,1183,0500000US55085,55085,"Oneida County, Wisconsin",Oneida County, Wisconsin,116,29,28,1,386,0,0,0,6,6,0,6,553,51,6,45,140,7,0,7,509,179,135,44,180,112,73,39
3094,160182,8637,3709,4928,0500000US55087,55087,"Outagamie County, Wisconsin",Outagamie County, Wisconsin,2606,768,437,331,4903,931,514,417,103,9,0,9,7919,1626,872,754,6316,849,453,396,2773,619,309,310,2742,608,341,267
3095,79311,3672,1306,2366,0500000US55089,55089,"Ozaukee County, Wisconsin",Ozaukee County, Wisconsin,1200,145,103,42,2376,17,0,17,48,0,0,0,2703,157,33,124,1814,106,48,58,152,12,0,12,621,60,12,48
3096,6921,706,293,413,0500000US55091,55091,"Pepin County, Wisconsin",Pepin County, Wisconsin,9,3,3,0,58,12,5,7,6,0,0,0,144,61,40,21,27,0,0,0,21,0,0,0,22,0,0,0
3097,37252,3074,1353,1721,0500000US55093,55093,"Pierce County, Wisconsin",Pierce County, Wisconsin,247,60,48,12,1030,88,28,60,59,2,0,2,877,131,70,61,241,38,13,25,49,0,0,0,158,16,2,14
3098,40816,3517,1490,2027,0500000US55095,55095,"Polk County, Wisconsin",Polk County, Wisconsin,141,29,20,9,754,216,107,109,15,1,1,0,805,214,102,112,178,17,7,10,379,90,17,73,124,47,38,9
3099,61391,6307,2740,3567,0500000US55097,55097,"Portage County, Wisconsin",Portage County, Wisconsin,427,96,54,42,1067,202,133,69,7,0,0,0,2221,445,209,236,2203,156,68,88,174,53,53,0,979,243,154,89
3100,12344,1426,662,764,0500000US55099,55099,"Price County, Wisconsin",Price County, Wisconsin,73,24,24,0,167,74,41,33,115,112,42,70,252,46,42,4,84,17,9,8,118,10,0,10,50,5,0,5
3101,136106,10709,4346,6363,0500000US55101,55101,"Racine County, Wisconsin",Racine County, Wisconsin,20395,6947,2922,4025,8346,1914,832,1082,104,0,0,0,25922,4662,1987,2675,2612,346,45,301,920,74,26,48,5546,1166,651,515
3102,16038,1953,877,1076,0500000US55103,55103,"Richland County, Wisconsin",Richland County, Wisconsin,72,25,23,2,273,90,15,75,1,0,0,0,417,89,5,84,116,49,44,5,37,1,1,0,383,152,28,124
3103,130491,12889,5465,7424,0500000US55105,55105,"Rock County, Wisconsin",Rock County, Wisconsin,7297,1858,796,1062,6352,1405,648,757,22,0,0,0,14454,3564,1667,1897,1620,220,165,55,486,48,48,0,7257,1114,440,674
3104,13072,1386,637,749,0500000US55107,55107,"Rusk County, Wisconsin",Rusk County, Wisconsin,68,38,14,24,318,103,42,61,10,0,0,0,277,31,4,27,29,19,5,14,27,4,0,4,45,2,0,2
3105,83135,4023,1639,2384,0500000US55109,55109,"St. Croix County, Wisconsin",St. Croix County, Wisconsin,608,93,65,28,1986,68,41,27,12,10,0,10,2190,359,160,199,834,70,36,34,150,0,0,0,550,97,50,47
3106,57385,4857,2004,2853,0500000US55111,55111,"Sauk County, Wisconsin",Sauk County, Wisconsin,354,96,59,37,1470,322,89,233,11,11,11,0,3299,355,239,116,331,15,13,2,789,68,48,20,1183,85,68,17
3107,12408,1147,468,679,0500000US55113,55113,"Sawyer County, Wisconsin",Sawyer County, Wisconsin,35,9,9,0,689,180,96,84,5,5,5,0,450,129,35,94,87,1,0,1,2710,965,514,451,124,68,21,47
3108,34632,2825,1196,1629,0500000US55115,55115,"Shawano County, Wisconsin",Shawano County, Wisconsin,102,4,4,0,1506,402,182,220,0,0,0,0,1151,199,86,113,158,11,0,11,2824,647,331,316,141,77,49,28
3109,94227,5478,2409,3069,0500000US55117,55117,"Sheboygan County, Wisconsin",Sheboygan County, Wisconsin,1814,400,165,235,3240,595,250,345,5,0,0,0,7325,1034,474,560,6653,720,247,473,239,40,29,11,1421,60,26,34
3110,19170,1708,682,1026,0500000US55119,55119,"Taylor County, Wisconsin",Taylor County, Wisconsin,7,0,0,0,352,89,57,32,13,0,0,0,442,26,18,8,74,12,0,12,45,4,2,2,18,0,0,0
3111,25882,1741,779,962,0500000US55121,55121,"Trempealeau County, Wisconsin",Trempealeau County, Wisconsin,114,43,34,9,345,13,5,8,75,75,0,75,2571,256,55,201,124,5,0,5,76,10,0,10,1448,140,27,113
3112,29150,4377,1791,2586,0500000US55123,55123,"Vernon County, Wisconsin",Vernon County, Wisconsin,50,22,22,0,601,47,18,29,11,0,0,0,488,77,18,59,104,13,1,12,46,13,7,6,156,30,15,15
3113,18399,1522,658,864,0500000US55125,55125,"Vilas County, Wisconsin",Vilas County, Wisconsin,70,9,9,0,603,60,12,48,13,8,0,8,556,41,19,22,126,33,17,16,1975,605,368,237,37,9,0,9
3114,85604,7289,3545,3744,0500000US55127,55127,"Walworth County, Wisconsin",Walworth County, Wisconsin,707,157,98,59,3766,570,214,356,67,44,0,44,11447,1623,680,943,807,101,65,36,347,29,1,28,2978,587,280,307
3115,14591,1613,782,831,0500000US55129,55129,"Washburn County, Wisconsin",Washburn County, Wisconsin,103,47,47,0,336,82,35,47,32,0,0,0,243,110,47,63,84,14,5,9,173,72,51,21,57,17,0,17
3116,124523,5685,2480,3205,0500000US55131,55131,"Washington County, Wisconsin",Washington County, Wisconsin,1797,315,114,201,2693,227,65,162,37,8,0,8,4427,706,299,407,1876,44,24,20,302,1,1,0,1147,225,98,127
3117,348149,15264,6456,8808,0500000US55133,55133,"Waukesha County, Wisconsin",Waukesha County, Wisconsin,5895,1002,524,478,9330,880,267,613,117,38,0,38,19271,2513,1111,1402,15078,415,122,293,831,162,118,44,5242,267,62,205
3118,46681,3925,1678,2247,0500000US55135,55135,"Waupaca County, Wisconsin",Waupaca County, Wisconsin,269,58,46,12,603,190,92,98,11,9,8,1,1633,259,182,77,286,120,76,44,246,43,16,27,574,15,10,5
3119,20893,1869,861,1008,0500000US55137,55137,"Waushara County, Wisconsin",Waushara County, Wisconsin,81,1,0,1,423,62,33,29,4,0,0,0,1407,447,181,266,101,7,3,4,78,43,18,25,784,236,81,155
3120,144117,14136,6378,7758,0500000US55139,55139,"Winnebago County, Wisconsin",Winnebago County, Wisconsin,2817,1409,786,623,4030,728,386,342,120,107,44,63,6764,1019,589,430,4848,538,265,273,688,62,23,39,1541,358,268,90
3121,66194,6171,2407,3764,0500000US55141,55141,"Wood County, Wisconsin",Wood County, Wisconsin,547,123,101,22,1478,230,76,154,3,0,0,0,2310,467,339,128,1524,0,0,0,365,46,15,31,521,93,86,7
3122,29641,6170,2969,3201,0500000US56001,56001,"Albany County, Wyoming",Albany County, Wyoming,432,152,110,42,1500,275,93,182,31,31,8,23,3491,752,439,313,1233,230,68,162,257,18,11,7,677,61,59,2
3123,10117,994,377,617,0500000US56003,56003,"Big Horn County, Wyoming",Big Horn County, Wyoming,41,4,0,4,250,11,0,11,14,0,0,0,1062,95,41,54,70,3,1,2,39,19,13,6,627,95,41,54
3124,40261,4196,1962,2234,0500000US56005,56005,"Campbell County, Wyoming",Campbell County, Wyoming,356,33,0,33,1739,347,147,200,29,0,0,0,3963,1041,565,476,68,1,0,1,521,383,142,241,573,28,1,27
3125,11100,1053,426,627,0500000US56007,56007,"Carbon County, Wyoming",Carbon County, Wyoming,120,21,1,20,482,145,88,57,5,5,0,5,2645,775,432,343,137,21,0,21,171,11,0,11,504,202,164,38
3126,12201,835,310,525,0500000US56009,56009,"Converse County, Wyoming",Converse County, Wyoming,0,0,0,0,456,98,63,35,0,0,0,0,1138,149,56,93,19,0,0,0,78,78,14,64,35,0,0,0
3127,6948,538,175,363,0500000US56011,56011,"Crook County, Wyoming",Crook County, Wyoming,0,0,0,0,167,0,0,0,0,0,0,0,182,81,73,8,18,0,0,0,80,0,0,0,11,1,0,1
3128,26932,2633,1275,1358,0500000US56013,56013,"Fremont County, Wyoming",Fremont County, Wyoming,161,36,36,0,1818,385,183,202,26,0,0,0,2825,643,307,336,97,33,0,33,8130,2147,1005,1142,471,34,30,4
3129,10653,879,451,428,0500000US56015,56015,"Goshen County, Wyoming",Goshen County, Wyoming,40,0,0,0,435,10,5,5,15,0,0,0,1314,152,6,146,113,0,0,0,86,4,4,0,296,114,113,1
3130,4087,586,262,324,0500000US56017,56017,"Hot Springs County, Wyoming",Hot Springs County, Wyoming,0,0,0,0,55,8,2,6,0,0,0,0,138,1,0,1,0,0,0,0,93,19,5,14,53,0,0,0
3131,7667,966,549,417,0500000US56019,56019,"Johnson County, Wyoming",Johnson County, Wyoming,49,18,18,0,98,26,17,9,0,0,0,0,405,276,263,13,129,0,0,0,87,0,0,0,0,0,0,0
3132,76103,5631,2332,3299,0500000US56021,56021,"Laramie County, Wyoming",Laramie County, Wyoming,1602,145,133,12,5719,341,229,112,149,4,0,4,14541,2513,1394,1119,1090,106,18,88,761,14,11,3,1930,369,251,118
3133,17904,1129,448,681,0500000US56023,56023,"Lincoln County, Wyoming",Lincoln County, Wyoming,8,0,0,0,716,177,47,130,0,0,0,0,915,135,29,106,69,1,0,1,59,6,3,3,110,44,9,35
3134,67733,5745,2625,3120,0500000US56025,56025,"Natrona County, Wyoming",Natrona County, Wyoming,822,267,61,206,2385,237,63,174,34,0,0,0,6775,1025,401,624,440,80,3,77,701,165,34,131,397,14,0,14
3135,1916,412,186,226,0500000US56027,56027,"Niobrara County, Wyoming",Niobrara County, Wyoming,18,0,0,0,45,0,0,0,35,35,0,35,95,7,4,3,0,0,0,0,1,0,0,0,0,0,0,0
3136,26041,1482,561,921,0500000US56029,56029,"Park County, Wyoming",Park County, Wyoming,193,127,64,63,895,64,20,44,0,0,0,0,1608,368,210,158,167,44,0,44,122,8,5,3,373,81,48,33
3137,7220,892,447,445,0500000US56031,56031,"Platte County, Wyoming",Platte County, Wyoming,0,0,0,0,403,12,6,6,50,0,0,0,693,26,16,10,58,0,0,0,0,0,0,0,11,0,0,0
3138,27059,2298,956,1342,0500000US56033,56033,"Sheridan County, Wyoming",Sheridan County, Wyoming,79,1,1,0,635,33,0,33,0,0,0,0,1252,92,27,65,223,12,12,0,504,47,29,18,204,0,0,0
3139,8729,596,264,332,0500000US56035,56035,"Sublette County, Wyoming",Sublette County, Wyoming,1,1,1,0,416,54,0,54,0,0,0,0,723,237,159,78,1,1,0,1,30,0,0,0,0,0,0,0
3140,33685,3457,1400,2057,0500000US56037,56037,"Sweetwater County, Wyoming",Sweetwater County, Wyoming,472,98,52,46,1838,171,128,43,33,0,0,0,6860,1237,635,602,352,86,33,53,473,50,1,49,662,51,49,2
3141,18891,1205,519,686,0500000US56039,56039,"Teton County, Wyoming",Teton County, Wyoming,171,20,19,1,432,5,2,3,19,0,0,0,3446,151,12,139,334,97,3,94,35,0,0,0,1545,132,10,122
3142,17655,1278,548,730,0500000US56041,56041,"Uinta County, Wyoming",Uinta County, Wyoming,54,1,0,1,861,113,77,36,0,0,0,0,1891,500,211,289,39,0,0,0,112,77,17,60,362,258,84,174
3143,6373,681,371,310,0500000US56043,56043,"Washakie County, Wyoming",Washakie County, Wyoming,0,0,0,0,365,0,0,0,0,0,0,0,1105,133,32,101,0,0,0,0,63,15,0,15,544,118,32,86
3144,5921,828,384,444,0500000US56045,56045,"Weston County, Wyoming",Weston County, Wyoming,34,34,0,34,189,129,129,0,118,0,0,0,87,0,0,0,105,0,0,0,37,0,0,0,0,0,0,0
3145,65,50,50,0,0500000US72001,72001,"Adjuntas Municipio, Puerto Rico",Adjuntas Municipio, Puerto Rico,250,168,79,89,657,592,295,297,0,0,0,0,17491,11328,5254,6074,2,2,0,2,21,5,5,0,3855,2516,1169,1347
3146,2334,895,547,348,0500000US72003,72003,"Aguada Municipio, Puerto Rico",Aguada Municipio, Puerto Rico,993,620,420,200,6497,3134,1427,1707,0,0,0,0,34475,16967,8183,8784,17,0,0,0,112,48,18,30,1177,747,306,441
3147,726,146,36,110,0500000US72005,72005,"Aguadilla Municipio, Puerto Rico",Aguadilla Municipio, Puerto Rico,1703,855,273,582,2480,1536,702,834,14,14,14,0,49563,25710,11350,14360,30,10,0,10,76,54,17,37,6448,3592,1820,1772
3148,93,86,0,86,0500000US72007,72007,"Aguas Buenas Municipio, Puerto Rico",Aguas Buenas Municipio, Puerto Rico,2207,1375,669,706,9715,4005,2148,1857,0,0,0,0,25013,11152,5756,5396,0,0,0,0,168,0,0,0,1695,858,451,407
3149,64,22,0,22,0500000US72009,72009,"Aibonito Municipio, Puerto Rico",Aibonito Municipio, Puerto Rico,3518,2119,1072,1047,2819,1199,593,606,0,0,0,0,22412,10075,4678,5397,24,0,0,0,74,58,45,13,1539,596,210,386
3150,1135,410,268,142,0500000US72011,72011,"Añasco Municipio, Puerto Rico",Añasco Municipio, Puerto Rico,519,234,165,69,4424,1987,1017,970,1,1,1,0,25124,11577,5501,6076,0,0,0,0,0,0,0,0,1595,758,319,439
3151,407,175,60,115,0500000US72013,72013,"Arecibo Municipio, Puerto Rico",Arecibo Municipio, Puerto Rico,3363,1288,652,636,6017,1950,718,1232,0,0,0,0,82495,38835,17372,21463,721,209,9,200,62,11,11,0,17176,9806,4479,5327
3152,34,34,14,20,0500000US72015,72015,"Arroyo Municipio, Puerto Rico",Arroyo Municipio, Puerto Rico,4536,2795,1582,1213,763,470,198,272,0,0,0,0,17456,10476,4787,5689,0,0,0,0,0,0,0,0,1238,512,292,220
3153,88,53,53,0,0500000US72017,72017,"Barceloneta Municipio, Puerto Rico",Barceloneta Municipio, Puerto Rico,805,275,223,52,2325,1009,494,515,0,0,0,0,23759,11035,5007,6028,154,75,0,75,0,0,0,0,3811,1577,839,738
3154,34,0,0,0,0500000US72019,72019,"Barranquitas Municipio, Puerto Rico",Barranquitas Municipio, Puerto Rico,1392,893,414,479,3790,1599,906,693,0,0,0,0,27768,14731,7118,7613,0,0,0,0,17,17,17,0,1189,624,176,448
3155,1238,469,198,271,0500000US72021,72021,"Bayamón Municipio, Puerto Rico",Bayamón Municipio, Puerto Rico,13813,4980,2289,2691,29601,11754,4945,6809,0,0,0,0,166919,57016,23985,33031,323,116,64,52,177,65,20,45,18905,6543,3028,3515
3156,147,0,0,0,0500000US72023,72023,"Cabo Rojo Municipio, Puerto Rico",Cabo Rojo Municipio, Puerto Rico,800,370,116,254,3387,1931,716,1215,0,0,0,0,47466,24247,11000,13247,129,0,0,0,110,42,42,0,31599,17592,8046,9546
3157,1679,567,281,286,0500000US72025,72025,"Caguas Municipio, Puerto Rico",Caguas Municipio, Puerto Rico,10336,4042,1670,2372,7206,3032,1411,1621,0,0,0,0,123785,45887,19969,25918,392,194,87,107,325,214,104,110,18135,6325,3221,3104
3158,218,153,116,37,0500000US72027,72027,"Camuy Municipio, Puerto Rico",Camuy Municipio, Puerto Rico,459,208,131,77,543,311,158,153,0,0,0,0,30730,13962,6213,7749,0,0,0,0,0,0,0,0,1868,783,348,435
3159,37,17,0,17,0500000US72029,72029,"Canóvanas Municipio, Puerto Rico",Canóvanas Municipio, Puerto Rico,5769,2178,759,1419,1492,352,179,173,0,0,0,0,44818,18529,8115,10414,331,79,0,79,25,25,25,0,17564,8777,4300,4477
3160,1297,280,152,128,0500000US72031,72031,"Carolina Municipio, Puerto Rico",Carolina Municipio, Puerto Rico,28612,10212,4091,6121,13582,3419,1554,1865,0,0,0,0,147505,45271,18295,26976,409,59,0,59,1773,886,311,575,31756,10232,3831,6401
3161,258,168,77,91,0500000US72033,72033,"Cataño Municipio, Puerto Rico",Cataño Municipio, Puerto Rico,2870,1441,711,730,3218,1065,573,492,0,0,0,0,23398,10900,5043,5857,43,0,0,0,8,8,0,8,2409,1184,555,629
3162,68,13,13,0,0500000US72035,72035,"Cayey Municipio, Puerto Rico",Cayey Municipio, Puerto Rico,3120,1177,556,621,13442,5991,2930,3061,0,0,0,0,42897,17264,7761,9503,100,100,48,52,27,0,0,0,2729,1245,536,709
3163,166,36,12,24,0500000US72037,72037,"Ceiba Municipio, Puerto Rico",Ceiba Municipio, Puerto Rico,753,362,171,191,767,204,82,122,0,0,0,0,10957,4673,2154,2519,66,0,0,0,61,0,0,0,3812,1952,1064,888
3164,120,64,51,13,0500000US72039,72039,"Ciales Municipio, Puerto Rico",Ciales Municipio, Puerto Rico,242,145,68,77,1528,777,401,376,0,0,0,0,15915,8720,4185,4535,13,13,0,13,149,149,94,55,612,262,162,100
3165,138,13,0,13,0500000US72041,72041,"Cidra Municipio, Puerto Rico",Cidra Municipio, Puerto Rico,4204,1906,920,986,7193,3248,1293,1955,0,0,0,0,38645,16818,7415,9403,0,0,0,0,82,32,17,15,3381,1044,480,564
3166,270,243,152,91,0500000US72043,72043,"Coamo Municipio, Puerto Rico",Coamo Municipio, Puerto Rico,10624,5064,2576,2488,4354,1961,957,1004,0,0,0,0,38217,18426,9207,9219,0,0,0,0,0,0,0,0,1252,609,284,325
3167,80,71,27,44,0500000US72045,72045,"Comerío Municipio, Puerto Rico",Comerío Municipio, Puerto Rico,1912,1176,512,664,1975,849,511,338,0,0,0,0,18821,10085,4445,5640,0,0,0,0,11,11,0,11,685,268,79,189
3168,383,319,222,97,0500000US72047,72047,"Corozal Municipio, Puerto Rico",Corozal Municipio, Puerto Rico,2408,1508,905,603,3403,1400,742,658,0,0,0,0,32379,16812,7876,8936,0,0,0,0,0,0,0,0,2998,1683,720,963
3169,99,26,14,12,0500000US72049,72049,"Culebra Municipio, Puerto Rico",Culebra Municipio, Puerto Rico,49,18,14,4,49,29,8,21,0,0,0,0,1233,390,160,230,28,16,4,12,0,0,0,0,558,193,63,130
3170,1027,98,66,32,0500000US72051,72051,"Dorado Municipio, Puerto Rico",Dorado Municipio, Puerto Rico,4217,2231,1176,1055,5410,1448,574,874,0,0,0,0,35368,11927,5148,6779,52,12,0,12,0,0,0,0,2183,483,139,344
3171,102,52,27,25,0500000US72053,72053,"Fajardo Municipio, Puerto Rico",Fajardo Municipio, Puerto Rico,3152,1233,542,691,2824,1214,465,749,0,0,0,0,29833,13299,5771,7528,138,18,0,18,16,16,16,0,9038,4287,1967,2320
3172,148,97,29,68,0500000US72054,72054,"Florida Municipio, Puerto Rico",Florida Municipio, Puerto Rico,257,0,0,0,1016,577,234,343,0,0,0,0,11347,5914,2561,3353,110,110,0,110,0,0,0,0,1720,1084,604,480
3173,129,21,21,0,0500000US72055,72055,"Guánica Municipio, Puerto Rico",Guánica Municipio, Puerto Rico,846,642,303,339,498,300,128,172,0,0,0,0,15558,10340,5023,5317,0,0,0,0,23,23,23,0,6131,4310,2228,2082
3174,187,34,0,34,0500000US72057,72057,"Guayama Municipio, Puerto Rico",Guayama Municipio, Puerto Rico,5561,2997,1285,1712,2880,1541,834,707,141,141,57,84,37416,18533,8537,9996,54,0,0,0,0,0,0,0,2998,1415,671,744
3175,47,25,25,0,0500000US72059,72059,"Guayanilla Municipio, Puerto Rico",Guayanilla Municipio, Puerto Rico,280,160,97,63,413,146,52,94,0,0,0,0,17933,9830,4468,5362,127,127,0,127,0,0,0,0,3369,2177,1151,1026
3176,1123,137,98,39,0500000US72061,72061,"Guaynabo Municipio, Puerto Rico",Guaynabo Municipio, Puerto Rico,5909,2264,909,1355,11012,2249,846,1403,0,0,0,0,83510,21284,9568,11716,64,29,19,10,172,48,5,43,11750,3474,1893,1581
3177,780,187,71,116,0500000US72063,72063,"Gurabo Municipio, Puerto Rico",Gurabo Municipio, Puerto Rico,5818,2692,939,1753,2518,358,144,214,0,0,0,0,45327,13547,6008,7539,72,60,32,28,50,22,13,9,11083,3510,1749,1761
3178,90,47,31,16,0500000US72065,72065,"Hatillo Municipio, Puerto Rico",Hatillo Municipio, Puerto Rico,562,106,22,84,1042,300,244,56,0,0,0,0,39286,17746,8173,9573,18,18,18,0,0,0,0,0,1689,792,352,440
3179,17,8,0,8,0500000US72067,72067,"Hormigueros Municipio, Puerto Rico",Hormigueros Municipio, Puerto Rico,419,168,88,80,400,25,20,5,0,0,0,0,15628,6605,2997,3608,0,0,0,0,0,0,0,0,11504,5438,2460,2978
3180,438,81,63,18,0500000US72069,72069,"Humacao Municipio, Puerto Rico",Humacao Municipio, Puerto Rico,10015,3603,1782,1821,960,439,196,243,0,0,0,0,50710,20365,8923,11442,369,129,0,129,111,0,0,0,16892,7505,3578,3927
3181,348,139,53,86,0500000US72071,72071,"Isabela Municipio, Puerto Rico",Isabela Municipio, Puerto Rico,2771,1119,449,670,1614,689,410,279,0,0,0,0,40016,20503,9935,10568,0,0,0,0,19,19,19,0,11692,6855,3360,3495
3182,120,69,0,69,0500000US72073,72073,"Jayuya Municipio, Puerto Rico",Jayuya Municipio, Puerto Rico,382,103,88,15,585,260,147,113,0,0,0,0,14080,8156,3952,4204,0,0,0,0,43,0,0,0,5911,3471,1727,1744
3183,58,0,0,0,0500000US72075,72075,"Juana Díaz Municipio, Puerto Rico",Juana Díaz Municipio, Puerto Rico,4046,2205,1024,1181,18201,8416,3719,4697,0,0,0,0,44899,20537,9133,11404,106,106,0,106,35,9,9,0,4050,2114,1100,1014
3184,140,44,44,0,0500000US72077,72077,"Juncos Municipio, Puerto Rico",Juncos Municipio, Puerto Rico,6571,3171,1537,1634,4111,1675,769,906,0,0,0,0,38183,16646,7529,9117,87,0,0,0,94,15,0,15,11012,4694,2052,2642
3185,237,186,34,152,0500000US72079,72079,"Lajas Municipio, Puerto Rico",Lajas Municipio, Puerto Rico,249,152,64,88,803,368,212,156,0,0,0,0,21941,13357,6266,7091,0,0,0,0,0,0,0,0,15514,10357,4989,5368
3186,43,20,11,9,0500000US72081,72081,"Lares Municipio, Puerto Rico",Lares Municipio, Puerto Rico,298,101,15,86,393,243,93,150,0,0,0,0,24585,14179,6728,7451,0,0,0,0,0,0,0,0,6431,3851,1836,2015
3187,34,8,8,0,0500000US72083,72083,"Las Marías Municipio, Puerto Rico",Las Marías Municipio, Puerto Rico,83,41,3,38,385,135,54,81,0,0,0,0,7987,3864,2018,1846,0,0,0,0,0,0,0,0,3538,1800,933,867
3188,33,9,0,9,0500000US72085,72085,"Las Piedras Municipio, Puerto Rico",Las Piedras Municipio, Puerto Rico,26056,10347,5144,5203,542,255,121,134,0,0,0,0,37085,14017,6634,7383,17,0,0,0,31,31,0,31,4773,1444,494,950
3189,6,0,0,0,0500000US72087,72087,"Loíza Municipio, Puerto Rico",Loíza Municipio, Puerto Rico,9267,4681,2278,2403,286,177,96,81,0,0,0,0,25050,12642,5375,7267,58,14,0,14,46,12,0,12,9409,5351,2120,3231
3190,114,28,28,0,0500000US72089,72089,"Luquillo Municipio, Puerto Rico",Luquillo Municipio, Puerto Rico,1672,376,150,226,1354,431,167,264,0,0,0,0,17750,7507,3378,4129,33,33,0,33,10,10,0,10,5598,3419,1652,1767
3191,620,304,187,117,0500000US72091,72091,"Manatí Municipio, Puerto Rico",Manatí Municipio, Puerto Rico,1368,552,227,325,3248,1368,553,815,0,0,0,0,37048,17049,7452,9597,141,97,0,97,29,29,13,16,4498,2388,1113,1275
3192,54,21,10,11,0500000US72093,72093,"Maricao Municipio, Puerto Rico",Maricao Municipio, Puerto Rico,96,9,9,0,225,84,17,67,0,0,0,0,5846,3404,1551,1853,0,0,0,0,22,0,0,0,2617,1672,865,807
3193,156,156,63,93,0500000US72095,72095,"Maunabo Municipio, Puerto Rico",Maunabo Municipio, Puerto Rico,7531,2982,1485,1497,10,0,0,0,0,0,0,0,10406,4476,2152,2324,0,0,0,0,8,8,8,0,1964,1078,422,656
3194,415,145,102,43,0500000US72097,72097,"Mayagüez Municipio, Puerto Rico",Mayagüez Municipio, Puerto Rico,2226,759,381,378,2315,1351,766,585,3,3,3,0,71913,38510,18092,20418,5,5,0,5,184,184,55,129,50006,28830,13454,15376
3195,102,63,0,63,0500000US72099,72099,"Moca Municipio, Puerto Rico",Moca Municipio, Puerto Rico,1412,646,240,406,1188,503,195,308,0,0,0,0,35173,18769,8763,10006,27,27,27,0,0,0,0,0,4314,2632,1408,1224
3196,95,95,29,66,0500000US72101,72101,"Morovis Municipio, Puerto Rico",Morovis Municipio, Puerto Rico,874,459,214,245,3686,1954,1076,878,0,0,0,0,30459,13509,6408,7101,0,0,0,0,37,0,0,0,1645,669,327,342
3197,162,46,46,0,0500000US72103,72103,"Naguabo Municipio, Puerto Rico",Naguabo Municipio, Puerto Rico,864,302,111,191,852,302,168,134,0,0,0,0,25580,12370,5603,6767,85,54,0,54,0,0,0,0,7924,4103,2169,1934
3198,1,0,0,0,0500000US72105,72105,"Naranjito Municipio, Puerto Rico",Naranjito Municipio, Puerto Rico,1555,1084,379,705,4713,2083,917,1166,0,0,0,0,27648,12701,6073,6628,0,0,0,0,0,0,0,0,282,129,76,53
3199,36,36,36,0,0500000US72107,72107,"Orocovis Municipio, Puerto Rico",Orocovis Municipio, Puerto Rico,894,666,337,329,2687,1724,856,868,0,0,0,0,20429,11721,5582,6139,0,0,0,0,50,39,26,13,1582,1131,501,630
3200,46,0,0,0,0500000US72109,72109,"Patillas Municipio, Puerto Rico",Patillas Municipio, Puerto Rico,12846,7069,3397,3672,220,51,34,17,0,0,0,0,16545,8435,4043,4392,0,0,0,0,0,0,0,0,2305,863,426,437
3201,83,23,23,0,0500000US72111,72111,"Peñuelas Municipio, Puerto Rico",Peñuelas Municipio, Puerto Rico,607,368,203,165,417,160,79,81,0,0,0,0,19646,10717,4954,5763,24,24,0,24,0,0,0,0,4629,2815,1253,1562
3202,630,222,134,88,0500000US72113,72113,"Ponce Municipio, Puerto Rico",Ponce Municipio, Puerto Rico,7779,4323,2039,2284,18780,11187,5252,5935,0,0,0,0,131696,67567,30949,36618,59,0,0,0,134,32,9,23,10029,5021,2168,2853
3203,250,92,68,24,0500000US72115,72115,"Quebradillas Municipio, Puerto Rico",Quebradillas Municipio, Puerto Rico,588,165,43,122,594,218,112,106,0,0,0,0,22870,10701,4421,6280,0,0,0,0,25,25,0,25,1938,755,257,498
3204,1118,254,130,124,0500000US72117,72117,"Rincón Municipio, Puerto Rico",Rincón Municipio, Puerto Rico,90,61,30,31,3228,1631,696,935,0,0,0,0,12489,5676,2750,2926,0,0,0,0,0,0,0,0,492,215,120,95
3205,171,108,0,108,0500000US72119,72119,"Río Grande Municipio, Puerto Rico",Río Grande Municipio, Puerto Rico,6749,2239,1108,1131,3628,1290,737,553,0,0,0,0,48059,18350,8019,10331,127,80,16,64,102,74,23,51,15347,6783,2827,3956
3206,123,28,0,28,0500000US72121,72121,"Sabana Grande Municipio, Puerto Rico",Sabana Grande Municipio, Puerto Rico,406,167,83,84,855,437,188,249,0,0,0,0,21872,10761,4488,6273,5,5,5,0,69,69,23,46,6640,3785,1537,2248
3207,19,0,0,0,0500000US72123,72123,"Salinas Municipio, Puerto Rico",Salinas Municipio, Puerto Rico,9854,5412,2847,2565,2450,1135,379,756,0,0,0,0,27412,13686,6112,7574,18,18,0,18,0,0,0,0,1029,630,230,400
3208,262,102,59,43,0500000US72125,72125,"San Germán Municipio, Puerto Rico",San Germán Municipio, Puerto Rico,441,134,83,51,922,461,219,242,22,0,0,0,29899,14600,6964,7636,0,0,0,0,9,0,0,0,11429,6347,3234,3113
3209,4851,1153,689,464,0500000US72127,72127,"San Juan Municipio, Puerto Rico",San Juan Municipio, Puerto Rico,43024,20671,8924,11747,31764,9994,4431,5563,71,50,18,32,315414,127292,54498,72794,828,209,100,109,732,220,125,95,61251,34195,15058,19137
3210,9,9,9,0,0500000US72129,72129,"San Lorenzo Municipio, Puerto Rico",San Lorenzo Municipio, Puerto Rico,11344,5234,2568,2666,1352,568,343,225,0,0,0,0,36360,15875,7282,8593,117,88,65,23,0,0,0,0,5245,2335,1020,1315
3211,1068,456,235,221,0500000US72131,72131,"San Sebastián Municipio, Puerto Rico",San Sebastián Municipio, Puerto Rico,1352,933,476,457,1779,847,525,322,0,0,0,0,34774,18056,8308,9748,108,58,0,58,0,0,0,0,10474,5212,2562,2650
3212,48,0,0,0,0500000US72133,72133,"Santa Isabel Municipio, Puerto Rico",Santa Isabel Municipio, Puerto Rico,7153,3579,1920,1659,2872,1926,951,975,0,0,0,0,21426,10384,5009,5375,0,0,0,0,22,0,0,0,648,172,70,102
3213,709,356,160,196,0500000US72135,72135,"Toa Alta Municipio, Puerto Rico",Toa Alta Municipio, Puerto Rico,5193,2050,1055,995,4487,869,374,495,5,5,5,0,71353,22036,9863,12173,42,0,0,0,99,50,50,0,4449,1584,810,774
3214,863,320,159,161,0500000US72137,72137,"Toa Baja Municipio, Puerto Rico",Toa Baja Municipio, Puerto Rico,8695,3282,1381,1901,7241,2510,1318,1192,0,0,0,0,74673,27261,12042,15219,0,0,0,0,5,0,0,0,9513,3759,1686,2073
3215,529,93,11,82,0500000US72139,72139,"Trujillo Alto Municipio, Puerto Rico",Trujillo Alto Municipio, Puerto Rico,6734,2555,1032,1523,6558,2027,773,1254,0,0,0,0,64121,18853,7934,10919,105,0,0,0,78,26,15,11,3838,1267,563,704
3216,164,66,10,56,0500000US72141,72141,"Utuado Municipio, Puerto Rico",Utuado Municipio, Puerto Rico,254,33,10,23,591,378,170,208,0,0,0,0,27705,15099,7191,7908,15,0,0,0,0,0,0,0,14511,8135,3944,4191
3217,280,136,45,91,0500000US72143,72143,"Vega Alta Municipio, Puerto Rico",Vega Alta Municipio, Puerto Rico,3285,1679,748,931,4047,1704,797,907,0,0,0,0,35673,16205,7886,8319,0,0,0,0,0,0,0,0,6769,3248,1801,1447
3218,1347,598,334,264,0500000US72145,72145,"Vega Baja Municipio, Puerto Rico",Vega Baja Municipio, Puerto Rico,2473,1014,544,470,4458,2078,1093,985,1,1,1,0,49378,22541,10265,12276,0,0,0,0,47,0,0,0,6169,3534,1519,2015
3219,520,215,128,87,0500000US72147,72147,"Vieques Municipio, Puerto Rico",Vieques Municipio, Puerto Rico,854,75,15,60,211,20,11,9,0,0,0,0,7890,4223,2023,2200,14,14,14,0,9,9,9,0,3645,2214,1052,1162
3220,33,25,25,0,0500000US72149,72149,"Villalba Municipio, Puerto Rico",Villalba Municipio, Puerto Rico,940,356,152,204,6474,2858,1337,1521,0,0,0,0,21707,10075,4613,5462,0,0,0,0,0,0,0,0,2209,865,430,435
3221,22,0,0,0,0500000US72151,72151,"Yabucoa Municipio, Puerto Rico",Yabucoa Municipio, Puerto Rico,22231,11736,5316,6420,660,265,119,146,0,0,0,0,32799,16966,7824,9142,0,0,0,0,0,0,0,0,5463,2730,1308,1422
3222,138,76,76,0,0500000US72153,72153,"Yauco Municipio, Puerto Rico",Yauco Municipio, Puerto Rico,1238,699,265,434,1314,651,360,291,0,0,0,0,34011,16598,7823,8775,5,5,5,0,85,73,19,54,6875,3816,1895,1921
3223,191779213,17854392,7879469,9974923,0100000US,,United States,United States,,39544837,8726814,3808033,4918781,16470117,2483493,1141059,1342434,592928,99642,45771,53871,58179884,10642653,4781792,5860861,18074164,1917691,888834,1028857,2596957,626766,289665,337101,16456568,3234981,1461235,1773746